,ncaa_match_id,ht,h_sets,at,a_sets,match_id,h_pts,a_pts,date,winner,loser,pt_diff,win_pts,lose_pts
1,5181974,Stanford,3,Lindenwood,0,5181974,75,48,1/5/2022,Stanford,Lindenwood,27,75,48
2,5181991,Hawaii,3,Loyola Chicago,0,5181991,75,55,1/5/2022,Hawaii,Loyola Chicago,20,75,55
3,5182067,Central St. (OH),2,Indiana Tech,3,5182067,95,109,1/6/2022,Indiana Tech,Central St. (OH),14,109,95
4,5182133,UC Santa Barbara,2,Southern California,3,5182133,103,101,1/6/2022,Southern California,UC Santa Barbara,-2,101,103
5,5182144,Penn St.,3,BYU,0,5182144,75,51,1/6/2022,Penn St.,BYU,24,75,51
6,5182270,Stanford,3,Lindenwood,0,5182270,78,64,1/6/2022,Stanford,Lindenwood,14,78,64
7,5182373,UC Santa Barbara,1,Southern California,3,5182373,82,95,1/7/2022,Southern California,UC Santa Barbara,13,95,82
8,5182483,Grand Canyon,3,McKendree,1,5182483,107,101,1/7/2022,Grand Canyon,McKendree,6,107,101
9,5182501,King (TN),0,Purdue Fort Wayne,3,5182501,60,75,1/7/2022,Purdue Fort Wayne,King (TN),15,75,60
10,5182505,UC Irvine,3,Lindenwood,0,5182505,77,63,1/7/2022,UC Irvine,Lindenwood,14,77,63
11,5182510,Hawaii,3,Loyola Chicago,1,5182510,93,74,1/7/2022,Hawaii,Loyola Chicago,19,93,74
12,5182773,Ohio St.,3,Central St. (OH),0,5182773,75,56,1/7/2022,Ohio St.,Central St. (OH),19,75,56
13,5183103,Ohio St.,3,Central St. (OH),0,5183103,75,50,1/8/2022,Ohio St.,Central St. (OH),25,75,50
14,5183108,Penn St.,3,BYU,0,5183108,76,64,1/8/2022,Penn St.,BYU,12,76,64
15,5183181,Erskine,2,Lancaster Bible,3,5183181,107,108,1/8/2022,Lancaster Bible,Erskine,1,108,107
16,5183186,Stanford,3,UC Irvine,2,5183186,117,114,1/8/2022,Stanford,UC Irvine,3,117,114
17,5183208,Grand Canyon,3,McKendree,1,5183208,97,80,1/8/2022,Grand Canyon,McKendree,17,97,80
18,5187618,Lincoln Memorial,3,Purdue Fort Wayne,0,5187618,75,58,1/8/2022,Lincoln Memorial,Purdue Fort Wayne,17,75,58
19,5183590,Belmont Abbey,3,LIU,0,5183590,75,48,1/10/2022,Belmont Abbey,LIU,27,75,48
20,5183626,CUI,3,St. Xavier,1,5183626,94,87,1/10/2022,CUI,St. Xavier,7,94,87
21,5183756,UC Santa Barbara,3,St. Xavier,0,5183756,75,55,1/11/2022,UC Santa Barbara,St. Xavier,20,75,55
22,5183824,Lewis,3,Maryville (MO),0,5183824,75,36,1/11/2022,Lewis,Maryville (MO),39,75,36
23,5184419,Belmont Abbey,3,LIU,0,5184419,79,67,1/11/2022,Belmont Abbey,LIU,12,79,67
24,5288419,Tusculum,1,North Greenville,3,5288419,74,94,1/11/2022,North Greenville,Tusculum,20,94,74
25,5184112,Ohio St.,3,Saint Francis (PA),0,5184112,75,51,1/12/2022,Ohio St.,Saint Francis (PA),24,75,51
26,5184336,UC Irvine,3,Harvard,0,5184336,75,62,1/12/2022,UC Irvine,Harvard,13,75,62
27,5184340,Southern California,3,Princeton,0,5184340,85,75,1/12/2022,Southern California,Princeton,10,85,75
28,5184469,Pepperdine,3,Erskine,0,5184469,75,43,1/13/2022,Pepperdine,Erskine,32,75,43
29,5184583,Emmanuel (GA),3,Queens (NC),2,5184583,106,101,1/13/2022,Emmanuel (GA),Queens (NC),5,106,101
30,5184586,Ball St.,3,Maryville (MO),0,5184586,75,43,1/13/2022,Ball St.,Maryville (MO),32,75,43
31,5184587,Penn St.,3,Grand Canyon,0,5184587,75,60,1/13/2022,Penn St.,Grand Canyon,15,75,60
32,5184635,Belmont Abbey,3,CarolinaU,0,5184635,75,49,1/13/2022,Belmont Abbey,CarolinaU,26,75,49
33,5184761,CUI,3,St. Katherine,0,5184761,75,46,1/13/2022,CUI,St. Katherine,29,75,46
34,5184861,Southern California,3,Erskine,0,5184861,75,42,1/14/2022,Southern California,Erskine,33,75,42
35,5184932,LIU,0,Springfield,3,5184932,56,75,1/14/2022,Springfield,LIU,19,75,56
36,5185095,Lewis,3,NJIT,1,5185095,93,75,1/14/2022,Lewis,NJIT,18,93,75
37,5185158,Pepperdine,3,Erskine,0,5185158,75,49,1/14/2022,Pepperdine,Erskine,26,75,49
38,5185164,UC San Diego,3,Harvard,1,5185164,91,84,1/14/2022,UC San Diego,Harvard,7,91,84
39,5185165,UC Irvine,3,Stanford,1,5185165,98,87,1/14/2022,UC Irvine,Stanford,11,98,87
40,5185175,Hawaii,3,Edward Waters,0,5185175,75,28,1/14/2022,Hawaii,Edward Waters,47,75,28
41,5185180,Purdue Fort Wayne,3,Maryville (MO),0,5185180,75,52,1/14/2022,Purdue Fort Wayne,Maryville (MO),23,75,52
42,5186042,Barton,0,George Mason,3,5186042,51,75,1/14/2022,George Mason,Barton,24,75,51
43,5191831,Campbellsville,2,Limestone,3,5191831,108,104,1/14/2022,Limestone,Campbellsville,-4,104,108
44,5235022,Loyola Chicago,3,Saint Francis (PA),0,5235022,75,58,1/14/2022,Loyola Chicago,Saint Francis (PA),17,75,58
45,5184439,Loyola Chicago,3,NJIT,1,5184439,97,85,1/15/2022,Loyola Chicago,NJIT,12,97,85
46,5185506,Ball St.,3,Tusculum,0,5185506,75,37,1/15/2022,Ball St.,Tusculum,38,75,37
47,5185640,King (TN),3,Fort Valley St.,0,5185640,75,49,1/15/2022,King (TN),Fort Valley St.,26,75,49
48,5185966,Mount Olive,3,George Mason,2,5185966,105,107,1/15/2022,Mount Olive,George Mason,-2,105,107
49,5185976,Lewis,3,Saint Francis (PA),0,5185976,79,65,1/15/2022,Lewis,Saint Francis (PA),14,79,65
50,5186066,UCLA,3,Princeton,0,5186066,75,56,1/15/2022,UCLA,Princeton,19,75,56
51,5186106,UC San Diego,3,Stanford,0,5186106,75,65,1/15/2022,UC San Diego,Stanford,10,75,65
52,5186116,Long Beach St.,3,Harvard,0,5186116,74,57,1/15/2022,Long Beach St.,Harvard,17,74,57
53,5188116,Queens (NC),3,Lees-McRae,0,5188116,77,57,1/15/2022,Queens (NC),Lees-McRae,20,77,57
54,5191283,Penn St.,3,Grand Canyon,0,5191283,75,49,1/15/2022,Penn St.,Grand Canyon,26,75,49
55,5186310,Hawaii,3,Edward Waters,0,5186310,75,29,1/16/2022,Hawaii,Edward Waters,46,75,29
56,5186606,Pepperdine,3,Princeton,0,5186606,75,61,1/17/2022,Pepperdine,Princeton,14,75,61
57,5186617,Long Beach St.,3,Erskine,0,5186617,75,39,1/17/2022,Long Beach St.,Erskine,36,75,39
58,5187601,Endicott,3,American Int'l,0,5187601,75,50,1/18/2022,Endicott,American Int'l,25,75,50
59,5188118,Queens (NC),1,Mount Olive,3,5188118,77,97,1/18/2022,Mount Olive,Queens (NC),20,97,77
60,5187255,UC Santa Barbara,1,Princeton,3,5187255,85,103,1/19/2022,Princeton,UC Santa Barbara,18,103,85
61,5198224,Mo. Baptist,3,Quincy,1,5198224,101,94,1/19/2022,Mo. Baptist,Quincy,7,101,94
62,5187897,Purdue Fort Wayne,2,George Mason,3,5187897,105,104,1/20/2022,George Mason,Purdue Fort Wayne,-1,104,105
63,5187927,Limestone,3,Erskine,0,5187927,83,65,1/20/2022,Limestone,Erskine,18,83,65
64,5188186,Loyola Chicago,3,Belmont Abbey,0,5188186,75,50,1/21/2022,Loyola Chicago,Belmont Abbey,25,75,50
65,5188236,American Int'l,0,Daemen,3,5188236,42,75,1/21/2022,Daemen,American Int'l,33,75,42
66,5188321,McKendree,3,Central St. (OH),0,5188321,75,42,1/21/2022,McKendree,Central St. (OH),33,75,42
67,5188387,Quincy,3,William Penn,0,5188387,75,57,1/21/2022,Quincy,William Penn,18,75,57
68,5188394,Harvard,3,Queens (NC),0,5188394,75,53,1/21/2022,Harvard,Queens (NC),22,75,53
69,5188404,Maryville (MO),3,Culver-Stockton,1,5188404,97,78,1/21/2022,Maryville (MO),Culver-Stockton,19,97,78
70,5188447,Lewis,1,Long Beach St.,3,5188447,90,99,1/21/2022,Long Beach St.,Lewis,9,99,90
71,5188467,UCLA,3,Ohio St.,2,5188467,111,91,1/21/2022,UCLA,Ohio St.,20,111,91
72,5188492,Fort Valley St.,3,Benedict,0,5188492,75,53,1/21/2022,Fort Valley St.,Benedict,22,75,53
73,5188505,Stanford,3,Vanguard,0,5188505,75,62,1/21/2022,Stanford,Vanguard,13,75,62
74,5188525,BYU,3,UC Irvine,2,5188525,107,110,1/21/2022,BYU,UC Irvine,-3,107,110
75,5188527,UC San Diego,1,Grand Canyon,3,5188527,86,99,1/21/2022,Grand Canyon,UC San Diego,13,99,86
76,5188532,Pepperdine,2,UC Santa Barbara,3,5188532,101,110,1/21/2022,UC Santa Barbara,Pepperdine,9,110,101
77,5188542,Penn St.,1,Southern California,3,5188542,86,98,1/21/2022,Southern California,Penn St.,12,98,86
78,5189709,Ball St.,3,George Mason,0,5189709,75,39,1/21/2022,Ball St.,George Mason,36,75,39
79,5220091,Randolph-Macon,3,Alderson Broaddus,0,5220091,75,46,1/21/2022,Randolph-Macon,Alderson Broaddus,29,75,46
80,5188585,Randolph-Macon,3,Alderson Broaddus,1,5188585,98,78,1/22/2022,Randolph-Macon,Alderson Broaddus,20,98,78
81,5188627,Edward Waters,3,Erskine,2,5188627,108,92,1/22/2022,Edward Waters,Erskine,16,108,92
82,5188629,American Int'l,0,Endicott,3,5188629,47,75,1/22/2022,Endicott,American Int'l,28,75,47
83,5188634,Sacred Heart,3,Daemen,2,5188634,106,98,1/22/2022,Sacred Heart,Daemen,8,106,98
84,5188703,Alderson Broaddus,3,East. Mennonite,1,5188703,99,82,1/22/2022,Alderson Broaddus,East. Mennonite,17,99,82
85,5188900,Queens (NC),3,King (TN),2,5188900,103,102,1/22/2022,Queens (NC),King (TN),1,103,102
86,5189068,St. Francis Brooklyn,1,Purdue Fort Wayne,3,5189068,65,95,1/22/2022,Purdue Fort Wayne,St. Francis Brooklyn,30,95,65
87,5189377,Quincy,3,St. Xavier,2,5189377,109,104,1/22/2022,Quincy,St. Xavier,5,109,104
88,5189527,Harvard,3,King (TN),0,5189527,75,51,1/22/2022,Harvard,King (TN),24,75,51
89,5189541,Lewis,3,Belmont Abbey,0,5189541,75,51,1/22/2022,Lewis,Belmont Abbey,24,75,51
90,5189554,Maryville (MO),3,Olivet Nazarene,0,5189554,75,58,1/22/2022,Maryville (MO),Olivet Nazarene,17,75,58
91,5189568,Lindenwood,3,Central St. (OH),0,5189568,75,59,1/22/2022,Lindenwood,Central St. (OH),16,75,59
92,5189588,Ohio St.,3,Southern California,1,5189588,92,88,1/22/2022,Ohio St.,Southern California,4,92,88
93,5189600,Loyola Chicago,0,Long Beach St.,3,5189600,56,75,1/22/2022,Long Beach St.,Loyola Chicago,19,75,56
94,5189641,Stanford,3,UC Santa Cruz,1,5189641,98,70,1/22/2022,Stanford,UC Santa Cruz,28,98,70
95,5189645,BYU,3,UC Irvine,0,5189645,75,61,1/22/2022,BYU,UC Irvine,14,75,61
96,5189666,CUI,3,Master's,0,5189666,75,56,1/22/2022,CUI,Master's,19,75,56
97,5189695,UCLA,3,Penn St.,1,5189695,95,92,1/22/2022,UCLA,Penn St.,3,95,92
98,5190738,Saint Francis (PA),3,LIU,0,5190738,75,62,1/22/2022,Saint Francis (PA),LIU,13,75,62
99,5213283,D'Youville,3,SUNY Potsdam,0,5213283,75,54,1/22/2022,D'Youville,SUNY Potsdam,21,75,54
100,5189774,NJIT,3,Purdue Fort Wayne,0,5189774,76,59,1/23/2022,NJIT,Purdue Fort Wayne,17,76,59
101,5189836,Princeton,2,Daemen,3,5189836,99,101,1/23/2022,Daemen,Princeton,2,101,99
102,5190472,Elmira,3,D'Youville,0,5190472,75,60,1/25/2022,Elmira,D'Youville,15,75,60
103,5190562,Fairleigh Dickinson,1,LIU,3,5190562,87,96,1/25/2022,LIU,Fairleigh Dickinson,9,96,87
104,5190575,Quincy,3,St. Ambrose,1,5190575,96,78,1/25/2022,Quincy,St. Ambrose,18,96,78
105,5190590,Lincoln Memorial,3,King (TN),2,5190590,107,104,1/25/2022,Lincoln Memorial,King (TN),3,107,104
106,5190614,Limestone,3,North Greenville,2,5190614,111,107,1/25/2022,Limestone,North Greenville,4,111,107
107,5191140,Southern California,3,UC Irvine,0,5191140,75,53,1/26/2022,Southern California,UC Irvine,22,75,53
108,5191549,Grand Canyon,3,Benedictine Mesa,0,5191549,75,47,1/27/2022,Grand Canyon,Benedictine Mesa,28,75,47
109,5191678,BYU,3,Mount Olive,2,5191678,111,102,1/27/2022,BYU,Mount Olive,9,111,102
110,5194943,UCLA,3,CSUN,0,5194943,77,65,1/27/2022,UCLA,CSUN,12,77,65
111,5191813,Judson (IL),3,Maryville (MO),1,5191813,99,89,1/28/2022,Judson (IL),Maryville (MO),10,99,89
112,5191819,Limestone,0,Charleston (WV),3,5191819,51,75,1/28/2022,Charleston (WV),Limestone,24,75,51
113,5191823,Grand Canyon,3,Master's,0,5191823,75,61,1/28/2022,Grand Canyon,Master's,14,75,61
114,5191849,Alderson Broaddus,1,North Greenville,3,5191849,81,90,1/28/2022,North Greenville,Alderson Broaddus,9,90,81
115,5191869,Sacred Heart,3,Lasell,0,5191869,75,54,1/28/2022,Sacred Heart,Lasell,21,75,54
116,5191873,King (TN),0,McKendree,3,5191873,49,75,1/28/2022,McKendree,King (TN),26,75,49
117,5191878,Lincoln Memorial,3,Loyola Chicago,0,5191878,75,58,1/28/2022,Lincoln Memorial,Loyola Chicago,17,75,58
118,5191940,Lees-McRae,3,Benedict,0,5191940,75,47,1/28/2022,Lees-McRae,Benedict,28,75,47
119,5191950,Queens (NC),3,Barton,0,5191950,77,57,1/28/2022,Queens (NC),Barton,20,77,57
120,5192036,Purdue Fort Wayne,3,Saint Francis (PA),1,5192036,98,91,1/28/2022,Purdue Fort Wayne,Saint Francis (PA),7,98,91
121,5192138,UC Santa Barbara,3,Penn St.,0,5192138,75,55,1/28/2022,UC Santa Barbara,Penn St.,20,75,55
122,5192149,Quincy,2,Missouri Valley,3,5192149,105,107,1/28/2022,Missouri Valley,Quincy,2,107,105
123,5192163,Long Beach St.,3,Ohio St.,1,5192163,99,83,1/28/2022,Long Beach St.,Ohio St.,16,99,83
124,5192183,Pepperdine,3,Lewis,0,5192183,75,60,1/28/2022,Pepperdine,Lewis,15,75,60
125,5192193,UC Irvine,2,Southern California,3,5192193,107,121,1/28/2022,Southern California,UC Irvine,14,121,107
126,5200974,Central St. (OH),0,Georgetown (KY),3,5200974,54,75,1/28/2022,Georgetown (KY),Central St. (OH),21,75,54
127,5244440,CSUN,3,Cal Lutheran,0,5244440,75,44,1/28/2022,CSUN,Cal Lutheran,31,75,44
128,5286063,St. Katherine,0,CUI,3,5286063,46,75,1/28/2022,CUI,St. Katherine,29,75,46
129,5290340,NJIT,3,UC San Diego,2,5290340,110,105,1/28/2022,NJIT,UC San Diego,5,110,105
130,5192248,Daemen,2,St. Francis Brooklyn,3,5192248,99,105,1/29/2022,St. Francis Brooklyn,Daemen,6,105,99
131,5192304,Daemen,3,LIU,0,5192304,78,62,1/29/2022,Daemen,LIU,16,78,62
132,5192340,Lees-McRae,3,Bluefield Col.,0,5192340,79,63,1/29/2022,Lees-McRae,Bluefield Col.,16,79,63
133,5192483,Geneva,2,Alderson Broaddus,3,5192483,98,110,1/29/2022,Alderson Broaddus,Geneva,12,110,98
134,5192548,Edward Waters,2,Emmanuel (GA),3,5192548,101,111,1/29/2022,Emmanuel (GA),Edward Waters,10,111,101
135,5192566,D'Youville,1,St. Francis Brooklyn,3,5192566,86,98,1/29/2022,St. Francis Brooklyn,D'Youville,12,98,86
136,5192633,Purdue Fort Wayne,2,Saint Francis (PA),3,5192633,109,108,1/29/2022,Saint Francis (PA),Purdue Fort Wayne,-1,108,109
137,5192637,Lincoln Memorial,3,McKendree,1,5192637,92,80,1/29/2022,Lincoln Memorial,McKendree,12,92,80
138,5192692,Queens (NC),3,Charleston (WV),1,5192692,98,86,1/29/2022,Queens (NC),Charleston (WV),12,98,86
139,5192776,D'Youville,1,LIU,3,5192776,88,100,1/29/2022,LIU,D'Youville,12,100,88
140,5192777,Princeton,2,UC San Diego,3,5192777,95,105,1/29/2022,UC San Diego,Princeton,10,105,95
141,5192799,Benedict,2,Bluefield Col.,3,5192799,103,110,1/29/2022,Bluefield Col.,Benedict,7,110,103
142,5192883,King (TN),2,Loyola Chicago,3,5192883,98,107,1/29/2022,Loyola Chicago,King (TN),9,107,98
143,5192910,BYU,3,Mount Olive,1,5192910,97,94,1/29/2022,BYU,Mount Olive,3,97,94
144,5192912,UC Santa Barbara,3,Ohio St.,1,5192912,101,79,1/29/2022,UC Santa Barbara,Ohio St.,22,101,79
145,5192979,Long Beach St.,2,Penn St.,3,5192979,107,110,1/29/2022,Penn St.,Long Beach St.,3,110,107
146,5193401,UCLA,0,Lewis,3,5193401,64,75,1/29/2022,Lewis,UCLA,11,75,64
147,5193623,Reinhardt,3,Fort Valley St.,0,5193623,75,61,1/29/2022,Reinhardt,Fort Valley St.,14,75,61
148,5193996,George Mason,3,North Greenville,1,5193996,97,92,1/29/2022,George Mason,North Greenville,5,97,92
149,5194586,Fort Valley St.,0,Belmont Abbey,3,5194586,52,60,1/29/2022,Belmont Abbey,Fort Valley St.,8,60,52
150,5213050,Ball St.,3,Hawaii,0,5213050,75,57,1/29/2022,Ball St.,Hawaii,18,75,57
151,5219982,Reinhardt,0,Belmont Abbey,2,5219982,63,71,1/29/2022,Belmont Abbey,Reinhardt,8,71,63
152,5234534,Limestone,3,Barton,1,5234534,93,74,1/29/2022,Limestone,Barton,19,93,74
153,5216883,Reinhardt,3,Emmanuel (GA),1,5216883,96,82,1/30/2022,Reinhardt,Emmanuel (GA),14,96,82
154,5193751,Erskine,3,Tusculum,1,5193751,98,87,1/31/2022,Erskine,Tusculum,11,98,87
155,5213053,Ball St.,3,Hawaii,2,5213053,111,104,1/31/2022,Ball St.,Hawaii,7,111,104
156,5194025,Daemen,3,Medaille,0,5194025,75,33,2/1/2022,Daemen,Medaille,42,75,33
157,5194086,North Greenville,3,Tusculum,0,5194086,75,50,2/1/2022,North Greenville,Tusculum,25,75,50
158,5194729,Sacred Heart,3,Fairleigh Dickinson,0,5194729,75,55,2/2/2022,Sacred Heart,Fairleigh Dickinson,20,75,55
159,5194793,Belmont Abbey,3,Benedict,1,5194793,97,68,2/2/2022,Belmont Abbey,Benedict,29,97,68
160,5194801,D'Youville,3,Hilbert,0,5194801,75,57,2/2/2022,D'Youville,Hilbert,18,75,57
161,5195072,Southern California,3,UC San Diego,0,5195072,82,71,2/2/2022,Southern California,UC San Diego,11,82,71
162,5195426,Lees-McRae,3,Edward Waters,1,5195426,94,80,2/3/2022,Lees-McRae,Edward Waters,14,94,80
163,5195459,Alvernia,1,LIU,3,5195459,91,95,2/3/2022,LIU,Alvernia,4,95,91
164,5195741,Hawaii,3,Fairleigh Dickinson,0,5195741,75,39,2/4/2022,Hawaii,Fairleigh Dickinson,36,75,39
165,5195786,Stanford,3,Fairleigh Dickinson,0,5195786,75,52,2/4/2022,Stanford,Fairleigh Dickinson,23,75,52
166,5195861,Benedict,0,Belmont Abbey,3,5195861,50,75,2/4/2022,Belmont Abbey,Benedict,25,75,50
167,5195874,NJIT,3,LIU,0,5195874,75,53,2/4/2022,NJIT,LIU,22,75,53
168,5195913,Lincoln Memorial,3,Erskine,0,5195913,75,45,2/4/2022,Lincoln Memorial,Erskine,30,75,45
169,5195965,Limestone,3,King (TN),1,5195965,98,78,2/4/2022,Limestone,King (TN),20,98,78
170,5195999,McKendree,3,Maryville (MO),0,5195999,75,43,2/4/2022,McKendree,Maryville (MO),32,75,43
171,5196006,Hawaii,3,Queens (NC),0,5196006,75,29,2/4/2022,Hawaii,Queens (NC),46,75,29
172,5196066,Charleston (WV),2,St. Francis Brooklyn,3,5196066,103,99,2/4/2022,St. Francis Brooklyn,Charleston (WV),-4,99,103
173,5196115,Loyola Chicago,0,Grand Canyon,3,5196115,60,76,2/4/2022,Grand Canyon,Loyola Chicago,16,76,60
174,5196127,Quincy,2,Grand View,3,5196127,108,116,2/4/2022,Grand View,Quincy,8,116,108
175,5196185,BYU,3,Ball St.,2,5196185,115,109,2/4/2022,BYU,Ball St.,6,115,109
176,5196186,CSUN,3,UC Merced,1,5196186,96,67,2/4/2022,CSUN,UC Merced,29,96,67
177,5196192,Long Beach St.,3,Southern California,1,5196192,90,88,2/4/2022,Long Beach St.,Southern California,2,90,88
178,5196215,UC Irvine,1,UCLA,3,5196215,85,97,2/4/2022,UCLA,UC Irvine,12,97,85
179,5196217,UC San Diego,1,CUI,3,5196217,91,94,2/4/2022,CUI,UC San Diego,3,94,91
180,5196428,Penn St.,3,Princeton,0,5196428,75,47,2/4/2022,Penn St.,Princeton,28,75,47
181,5219085,Saint Francis (PA),3,George Mason,0,5219085,79,67,2/4/2022,Saint Francis (PA),George Mason,12,79,67
182,5275912,UC Santa Barbara,3,Pepperdine,1,5275912,99,83,2/4/2022,UC Santa Barbara,Pepperdine,16,99,83
183,5288420,Tusculum,3,Alderson Broaddus,1,5288420,97,78,2/4/2022,Tusculum,Alderson Broaddus,19,97,78
184,5195978,Sacred Heart,1,Purdue Fort Wayne,3,5195978,84,99,2/5/2022,Purdue Fort Wayne,Sacred Heart,15,99,84
185,5196253,American Int'l,0,Nichols,3,5196253,60,79,2/5/2022,Nichols,American Int'l,19,79,60
186,5196709,American Int'l,3,Russell Sage,0,5196709,75,55,2/5/2022,American Int'l,Russell Sage,20,75,55
187,5196771,North Greenville,3,Edward Waters,0,5196771,75,63,2/5/2022,North Greenville,Edward Waters,12,75,63
188,5196925,Limestone,3,Alderson Broaddus,0,5196925,75,51,2/5/2022,Limestone,Alderson Broaddus,24,75,51
189,5196959,Lincoln Memorial,3,Emmanuel (GA),0,5196959,75,44,2/5/2022,Lincoln Memorial,Emmanuel (GA),31,75,44
190,5197343,Morehouse,0,Webber Int'l,3,5197343,40,75,2/5/2022,Webber Int'l,Morehouse,35,75,40
191,5197372,Saint Francis (PA),3,Princeton,1,5197372,96,87,2/5/2022,Saint Francis (PA),Princeton,9,96,87
192,5197420,LIU,0,NJIT,3,5197420,61,75,2/5/2022,NJIT,LIU,14,75,61
193,5197458,Hawaii,3,Stanford,1,5197458,94,77,2/5/2022,Hawaii,Stanford,17,94,77
194,5197485,Charleston (WV),3,St. Francis Brooklyn,0,5197485,75,61,2/5/2022,Charleston (WV),St. Francis Brooklyn,14,75,61
195,5197528,Lindenwood,3,Maryville (MO),0,5197528,75,43,2/5/2022,Lindenwood,Maryville (MO),32,75,43
196,5197568,Harvard,1,Purdue Fort Wayne,3,5197568,86,96,2/5/2022,Purdue Fort Wayne,Harvard,10,96,86
197,5197604,Lewis,3,Grand Canyon,2,5197604,105,107,2/5/2022,Lewis,Grand Canyon,-2,105,107
198,5197665,BYU,1,Ball St.,3,5197665,95,106,2/5/2022,Ball St.,BYU,11,106,95
199,5199142,UCLA,3,UC Irvine,2,5199142,104,98,2/5/2022,UCLA,UC Irvine,6,104,98
200,5209359,Penn St.,3,George Mason,0,5209359,75,55,2/5/2022,Penn St.,George Mason,20,75,55
201,5261663,Queens (NC),3,Fairleigh Dickinson,1,5261663,98,77,2/5/2022,Queens (NC),Fairleigh Dickinson,21,98,77
202,5288437,Tusculum,1,Erskine,3,5288437,87,97,2/5/2022,Erskine,Tusculum,10,97,87
203,5197892,Daemen,3,St. John Fisher,2,5197892,112,114,2/6/2022,Daemen,St. John Fisher,-2,112,114
204,5199322,Alderson Broaddus,3,Saint Vincent,0,5199322,75,58,2/8/2022,Alderson Broaddus,Saint Vincent,17,75,58
205,5199323,King (TN),3,Lees-McRae,0,5199323,75,54,2/8/2022,King (TN),Lees-McRae,21,75,54
206,5199359,Erskine,3,North Greenville,1,5199359,96,84,2/8/2022,Erskine,North Greenville,12,96,84
207,5199421,Emmanuel (GA),3,Limestone,2,5199421,102,104,2/8/2022,Emmanuel (GA),Limestone,-2,102,104
208,5199494,Maryville (MO),2,Mo. Baptist,3,5199494,100,112,2/8/2022,Mo. Baptist,Maryville (MO),12,112,100
209,5199540,Hawaii,3,LIU,0,5199540,76,50,2/8/2022,Hawaii,LIU,26,76,50
210,5200049,Maryville (MO),3,UHSP,0,5200049,77,52,2/9/2022,Maryville (MO),UHSP,25,77,52
211,5200231,CSUN,3,Vanguard,0,5200231,75,47,2/9/2022,CSUN,Vanguard,28,75,47
212,5200254,Southern California,3,UC Santa Barbara,0,5200254,75,65,2/9/2022,Southern California,UC Santa Barbara,10,75,65
213,5200255,Pepperdine,3,UC Irvine,0,5200255,77,63,2/9/2022,Pepperdine,UC Irvine,14,77,63
214,5200272,Hawaii,3,LIU,0,5200272,75,39,2/9/2022,Hawaii,LIU,36,75,39
215,5200323,D'Youville,3,Wells,0,5200323,75,42,2/9/2022,D'Youville,Wells,33,75,42
216,5200476,UC San Diego,1,UCLA,3,5200476,82,97,2/9/2022,UCLA,UC San Diego,15,97,82
217,5200454,Loyola Chicago,3,Quincy,0,5200454,75,49,2/10/2022,Loyola Chicago,Quincy,26,75,49
218,5200667,Lewis,0,Ball St.,3,5200667,71,81,2/10/2022,Ball St.,Lewis,10,81,71
219,5200685,McKendree,3,Ohio St.,1,5200685,96,85,2/10/2022,McKendree,Ohio St.,11,96,85
220,5200807,Southern California,3,CSUN,0,5200807,75,61,2/10/2022,Southern California,CSUN,14,75,61
221,5201174,NJIT,3,George Mason,0,5201174,75,60,2/11/2022,NJIT,George Mason,15,75,60
222,5201347,Lees-McRae,0,Emmanuel (GA),3,5201347,56,75,2/11/2022,Emmanuel (GA),Lees-McRae,19,75,56
223,5201348,King (TN),3,Erskine,0,5201348,75,50,2/11/2022,King (TN),Erskine,25,75,50
224,5201378,Central St. (OH),0,Maryville (MO),3,5201378,63,75,2/11/2022,Maryville (MO),Central St. (OH),12,75,63
225,5201405,Belmont Abbey,3,Barton,0,5201405,75,53,2/11/2022,Belmont Abbey,Barton,22,75,53
226,5201419,Lincoln Memorial,3,Queens (NC),1,5201419,98,73,2/11/2022,Lincoln Memorial,Queens (NC),25,98,73
227,5201538,Sacred Heart,2,Saint Francis (PA),3,5201538,98,101,2/11/2022,Saint Francis (PA),Sacred Heart,3,101,98
228,5201577,Harvard,0,Penn St.,3,5201577,68,78,2/11/2022,Penn St.,Harvard,10,78,68
229,5201602,North Greenville,3,Mount Olive,2,5201602,108,108,2/11/2022,North Greenville,Mount Olive,0,108,108
230,5201624,Purdue Fort Wayne,3,Lindenwood,1,5201624,100,81,2/11/2022,Purdue Fort Wayne,Lindenwood,19,100,81
231,5201724,Grand Canyon,2,UC Santa Barbara,3,5201724,112,106,2/11/2022,UC Santa Barbara,Grand Canyon,-6,106,112
232,5201782,Stanford,3,Menlo,0,5201782,78,62,2/11/2022,Stanford,Menlo,16,78,62
233,5201783,Long Beach St.,3,UCLA,0,5201783,75,58,2/11/2022,Long Beach St.,UCLA,17,75,58
234,5201804,BYU,2,UC San Diego,3,5201804,110,119,2/11/2022,UC San Diego,BYU,9,119,110
235,5201817,UC Irvine,3,Pepperdine,1,5201817,89,91,2/11/2022,UC Irvine,Pepperdine,-2,89,91
236,5201872,Hawaii,3,LIU,1,5201872,97,67,2/11/2022,Hawaii,LIU,30,97,67
237,5288435,Tusculum,0,Limestone,3,5288435,59,78,2/11/2022,Limestone,Tusculum,19,78,59
238,5202009,Wittenberg,0,Maryville (MO),3,5202009,58,75,2/12/2022,Maryville (MO),Wittenberg,17,75,58
239,5202058,Daemen,3,American Int'l,0,5202058,75,37,2/12/2022,Daemen,American Int'l,38,75,37
240,5202277,Lees-McRae,3,Erskine,0,5202277,76,62,2/12/2022,Lees-McRae,Erskine,14,76,62
241,5202279,Lincoln Memorial,3,Limestone,0,5202279,75,55,2/12/2022,Lincoln Memorial,Limestone,20,75,55
242,5202584,King (TN),3,Emmanuel (GA),2,5202584,111,94,2/12/2022,King (TN),Emmanuel (GA),17,111,94
243,5202687,Purdue Fort Wayne,3,Quincy,0,5202687,77,65,2/12/2022,Purdue Fort Wayne,Quincy,12,77,65
244,5202720,NJIT,3,Princeton,1,5202720,92,92,2/12/2022,NJIT,Princeton,0,92,92
245,5202744,Central St. (OH),2,Maryville (MO),3,5202744,116,115,2/12/2022,Maryville (MO),Central St. (OH),-1,115,116
246,5203402,D'Youville,3,American Int'l,0,5203402,75,43,2/12/2022,D'Youville,American Int'l,32,75,43
247,5203425,Lewis,3,Ohio St.,1,5203425,94,94,2/12/2022,Lewis,Ohio St.,0,94,94
248,5203474,Charleston (WV),3,Fort Valley St.,0,5203474,75,41,2/12/2022,Charleston (WV),Fort Valley St.,34,75,41
249,5203524,Belmont Abbey,1,Mount Olive,3,5203524,79,101,2/12/2022,Mount Olive,Belmont Abbey,22,101,79
250,5203556,St. Francis Brooklyn,3,George Mason,2,5203556,98,109,2/12/2022,St. Francis Brooklyn,George Mason,-11,98,109
251,5203606,McKendree,1,Ball St.,3,5203606,85,97,2/12/2022,Ball St.,McKendree,12,97,85
252,5203709,Loyola Chicago,3,Lindenwood,1,5203709,97,87,2/12/2022,Loyola Chicago,Lindenwood,10,97,87
253,5203776,BYU,2,UC San Diego,3,5203776,99,102,2/12/2022,UC San Diego,BYU,3,102,99
254,5203848,North Greenville,3,Barton,2,5203848,110,97,2/12/2022,North Greenville,Barton,13,110,97
255,5215795,Sacred Heart,0,Penn St.,3,5215795,46,75,2/12/2022,Penn St.,Sacred Heart,29,75,46
256,5232312,Grand Canyon,2,UC Santa Barbara,3,5232312,97,106,2/12/2022,UC Santa Barbara,Grand Canyon,9,106,97
257,5235024,Harvard,1,Saint Francis (PA),3,5235024,92,96,2/12/2022,Saint Francis (PA),Harvard,4,96,92
258,5288421,Tusculum,0,Queens (NC),3,5288421,62,75,2/12/2022,Queens (NC),Tusculum,13,75,62
259,5204016,Charleston (WV),3,Fort Valley St.,0,5204016,75,37,2/13/2022,Charleston (WV),Fort Valley St.,38,75,37
260,5204338,St. Francis Brooklyn,1,Princeton,3,5204338,88,96,2/13/2022,Princeton,St. Francis Brooklyn,8,96,88
261,5205605,American Int'l,0,Sacred Heart,3,5205605,43,75,2/15/2022,Sacred Heart,American Int'l,32,75,43
262,5205616,King (TN),0,North Greenville,3,5205616,60,75,2/15/2022,North Greenville,King (TN),15,75,60
263,5205636,Fairleigh Dickinson,0,St. Francis Brooklyn,3,5205636,50,79,2/15/2022,St. Francis Brooklyn,Fairleigh Dickinson,29,79,50
264,5205648,Erskine,3,Emmanuel (GA),1,5205648,96,84,2/15/2022,Erskine,Emmanuel (GA),12,96,84
265,5214663,Daemen,3,Elmira,0,5214663,75,62,2/15/2022,Daemen,Elmira,13,75,62
266,5206261,Limestone,3,Belmont Abbey,0,5206261,75,59,2/16/2022,Limestone,Belmont Abbey,16,75,59
267,5206352,Quincy,0,McKendree,3,5206352,52,75,2/16/2022,McKendree,Quincy,23,75,52
268,5206552,Mo. Baptist,3,Maryville (MO),1,5206552,97,75,2/16/2022,Mo. Baptist,Maryville (MO),22,97,75
269,5207006,Ball St.,3,Purdue Fort Wayne,2,5207006,114,100,2/17/2022,Ball St.,Purdue Fort Wayne,14,114,100
270,5207009,Ohio St.,2,Loyola Chicago,3,5207009,114,115,2/17/2022,Loyola Chicago,Ohio St.,1,115,114
271,5207517,Stanford,3,CSUN,0,5207517,76,54,2/18/2022,Stanford,CSUN,22,76,54
272,5207615,Lindenwood,3,Lewis,2,5207615,106,105,2/18/2022,Lindenwood,Lewis,1,106,105
273,5207683,Saint Francis (PA),3,Queens (NC),0,5207683,75,59,2/18/2022,Saint Francis (PA),Queens (NC),16,75,59
274,5207685,LIU,3,D'Youville,0,5207685,75,52,2/18/2022,LIU,D'Youville,23,75,52
275,5207701,Sacred Heart,0,NJIT,3,5207701,58,75,2/18/2022,NJIT,Sacred Heart,17,75,58
276,5207725,Russell Sage,1,American Int'l,3,5207725,72,94,2/18/2022,American Int'l,Russell Sage,22,94,72
277,5207753,Benedict,3,Morehouse,0,5207753,75,50,2/18/2022,Benedict,Morehouse,25,75,50
278,5207904,Campbellsville,4,Central St. (OH),0,5207904,103,71,2/18/2022,Campbellsville,Central St. (OH),32,103,71
279,5207947,Harvard,3,St. Francis Brooklyn,1,5207947,96,82,2/18/2022,Harvard,St. Francis Brooklyn,14,96,82
280,5208058,Grand Canyon,1,Pepperdine,3,5208058,99,115,2/18/2022,Pepperdine,Grand Canyon,16,115,99
281,5208123,UC San Diego,3,UC Santa Cruz,0,5208123,75,61,2/18/2022,UC San Diego,UC Santa Cruz,14,75,61
282,5208147,UC Irvine,3,CUI,0,5208147,77,69,2/18/2022,UC Irvine,CUI,8,77,69
283,5208191,Hawaii,3,Lincoln Memorial,0,5208191,75,63,2/18/2022,Hawaii,Lincoln Memorial,12,75,63
284,5210477,UC Santa Barbara,3,BYU,0,5210477,75,62,2/18/2022,UC Santa Barbara,BYU,13,75,62
285,5219643,Emmanuel (GA),3,Edward Waters,1,5219643,105,92,2/18/2022,Emmanuel (GA),Edward Waters,13,105,92
286,5288438,Tusculum,3,Fort Valley St.,0,5288438,75,50,2/18/2022,Tusculum,Fort Valley St.,25,75,50
287,5208946,Lees-McRae,1,North Greenville,3,5208946,85,98,2/19/2022,North Greenville,Lees-McRae,13,98,85
288,5209102,Maryville (MO),2,Graceland (IA),0,5209102,76,54,2/19/2022,Maryville (MO),Graceland (IA),22,76,54
289,5209307,Ball St.,1,Loyola Chicago,3,5209307,89,94,2/19/2022,Loyola Chicago,Ball St.,5,94,89
290,5209334,Limestone,3,Edward Waters,0,5209334,75,54,2/19/2022,Limestone,Edward Waters,21,75,54
291,5209531,UHSP,1,Maryville (MO),3,5209531,67,93,2/19/2022,Maryville (MO),UHSP,26,93,67
292,5209576,Lindenwood,0,McKendree,3,5209576,65,77,2/19/2022,McKendree,Lindenwood,12,77,65
293,5209632,George Mason,3,Queens (NC),2,5209632,106,98,2/19/2022,George Mason,Queens (NC),8,106,98
294,5209807,Fairleigh Dickinson,3,D'Youville,0,5209807,75,68,2/19/2022,Fairleigh Dickinson,D'Youville,7,75,68
295,5209821,Penn St.,3,Saint Francis (PA),0,5209821,75,51,2/19/2022,Penn St.,Saint Francis (PA),24,75,51
296,5209883,Sacred Heart,2,St. Francis Brooklyn,3,5209883,100,107,2/19/2022,St. Francis Brooklyn,Sacred Heart,7,107,100
297,5209987,Quincy,0,Lewis,3,5209987,59,75,2/19/2022,Lewis,Quincy,16,75,59
298,5210371,UCLA,3,Long Beach St.,2,5210371,109,105,2/19/2022,UCLA,Long Beach St.,4,109,105
299,5210415,UC San Diego,3,CUI,0,5210415,75,63,2/19/2022,UC San Diego,CUI,12,75,63
300,5210463,Harvard,3,NJIT,1,5210463,100,85,2/19/2022,Harvard,NJIT,15,100,85
301,5210488,Hawaii,3,Lincoln Memorial,0,5210488,75,44,2/19/2022,Hawaii,Lincoln Memorial,31,75,44
302,5210607,Belmont Abbey,3,Erskine,0,5210607,83,72,2/19/2022,Belmont Abbey,Erskine,11,83,72
303,5211759,Princeton,3,Charleston (WV),0,5211759,75,59,2/19/2022,Princeton,Charleston (WV),16,75,59
304,5214792,UC Santa Barbara,3,BYU,1,5214792,105,100,2/19/2022,UC Santa Barbara,BYU,5,105,100
305,5210653,Fairleigh Dickinson,3,D'Youville,0,5210653,75,51,2/20/2022,Fairleigh Dickinson,D'Youville,24,75,51
306,5211021,Ohio St.,3,Purdue Fort Wayne,0,5211021,75,62,2/20/2022,Ohio St.,Purdue Fort Wayne,13,75,62
307,5211064,Grand Canyon,3,Pepperdine,1,5211064,95,83,2/20/2022,Grand Canyon,Pepperdine,12,95,83
308,5211620,Hawaii,3,Lincoln Memorial,1,5211620,97,75,2/20/2022,Hawaii,Lincoln Memorial,22,97,75
309,5212798,Erskine,3,Benedict,0,5212798,75,56,2/22/2022,Erskine,Benedict,19,75,56
310,5212932,St. Francis Brooklyn,3,LIU,2,5212932,108,104,2/22/2022,St. Francis Brooklyn,LIU,4,108,104
311,5227305,Emmanuel (GA),2,Tusculum,3,5227305,109,114,2/22/2022,Tusculum,Emmanuel (GA),5,114,109
312,5213469,North Greenville,3,Bluefield Col.,0,5213469,75,55,2/23/2022,North Greenville,Bluefield Col.,20,75,55
313,5213496,Daemen,3,Nazareth,1,5213496,93,83,2/23/2022,Daemen,Nazareth,10,93,83
314,5213567,Barton,0,Mount Olive,3,5213567,44,75,2/23/2022,Mount Olive,Barton,31,75,44
315,5213790,Maryville (MO),3,Fontbonne,1,5213790,95,91,2/23/2022,Maryville (MO),Fontbonne,4,95,91
316,5213874,CSUN,3,St. Katherine,0,5213874,75,55,2/23/2022,CSUN,St. Katherine,20,75,55
317,5213893,UCLA,3,CUI,1,5213893,95,80,2/23/2022,UCLA,CUI,15,95,80
318,5213914,Pepperdine,3,Southern California,2,5213914,115,107,2/23/2022,Pepperdine,Southern California,8,115,107
319,5213988,Belmont Abbey,3,Lees-McRae,0,5213988,75,59,2/23/2022,Belmont Abbey,Lees-McRae,16,75,59
320,5214290,Queens (NC),3,Limestone,1,5214290,99,89,2/24/2022,Queens (NC),Limestone,10,99,89
321,5214381,Ball St.,3,Lindenwood,1,5214381,98,90,2/24/2022,Ball St.,Lindenwood,8,98,90
322,5214448,Lewis,0,Purdue Fort Wayne,3,5214448,68,75,2/24/2022,Purdue Fort Wayne,Lewis,7,75,68
323,5214492,McKendree,3,Loyola Chicago,2,5214492,106,98,2/24/2022,McKendree,Loyola Chicago,8,106,98
324,5214638,Ohio St.,3,Quincy,0,5214638,75,53,2/24/2022,Ohio St.,Quincy,22,75,53
325,5214596,UC Santa Barbara,3,UC San Diego,1,5214596,98,85,2/25/2022,UC Santa Barbara,UC San Diego,13,98,85
326,5215106,Mount Olive,3,King (TN),2,5215106,117,109,2/25/2022,Mount Olive,King (TN),8,117,109
327,5215113,NJIT,3,Saint Francis (PA),0,5215113,75,63,2/25/2022,NJIT,Saint Francis (PA),12,75,63
328,5215130,Ball St.,3,Quincy,0,5215130,75,58,2/25/2022,Ball St.,Quincy,17,75,58
329,5215165,D'Youville,0,Central St. (OH),3,5215165,58,75,2/25/2022,Central St. (OH),D'Youville,17,75,58
330,5215180,Ohio St.,3,Lindenwood,0,5215180,75,55,2/25/2022,Ohio St.,Lindenwood,20,75,55
331,5215181,St. Francis Brooklyn,0,Penn St.,3,5215181,57,77,2/25/2022,Penn St.,St. Francis Brooklyn,20,77,57
332,5215190,Barton,2,Lees-McRae,3,5215190,121,125,2/25/2022,Lees-McRae,Barton,4,125,121
333,5215337,Queens (NC),3,Belmont Abbey,2,5215337,105,91,2/25/2022,Queens (NC),Belmont Abbey,14,105,91
334,5215344,Charleston (WV),3,Sacred Heart,1,5215344,94,90,2/25/2022,Charleston (WV),Sacred Heart,4,94,90
335,5215351,George Mason,3,Fairleigh Dickinson,1,5215351,103,88,2/25/2022,George Mason,Fairleigh Dickinson,15,103,88
336,5215554,BYU,1,Grand Canyon,3,5215554,85,96,2/25/2022,Grand Canyon,BYU,11,96,85
337,5215582,CUI,0,UCLA,3,5215582,48,75,2/25/2022,UCLA,CUI,27,75,48
338,5215618,Long Beach St.,3,Stanford,0,5215618,75,59,2/25/2022,Long Beach St.,Stanford,16,75,59
339,5215631,Southern California,3,Pepperdine,1,5215631,97,87,2/25/2022,Southern California,Pepperdine,10,97,87
340,5215760,Mount Olive,3,Lees-McRae,1,5215760,98,65,2/26/2022,Mount Olive,Lees-McRae,33,98,65
341,5215807,Kentucky St.,0,Maryville (MO),3,5215807,50,76,2/26/2022,Maryville (MO),Kentucky St.,26,76,50
342,5215893,Daemen,3,Central St. (OH),0,5215893,75,61,2/26/2022,Daemen,Central St. (OH),14,75,61
343,5216050,Charleston (WV),2,Sacred Heart,3,5216050,108,105,2/26/2022,Sacred Heart,Charleston (WV),-3,105,108
344,5216151,Emmanuel (GA),3,Belmont Abbey,1,5216151,94,85,2/26/2022,Emmanuel (GA),Belmont Abbey,9,94,85
345,5216210,Kentucky St.,0,Maryville (MO),3,5216210,55,75,2/26/2022,Maryville (MO),Kentucky St.,20,75,55
346,5216353,North Greenville,3,Erskine,0,5216353,75,55,2/26/2022,North Greenville,Erskine,20,75,55
347,5216589,Randolph-Macon,3,Tusculum,1,5216589,100,91,2/26/2022,Randolph-Macon,Tusculum,9,100,91
348,5216884,George Mason,2,Princeton,3,5216884,103,109,2/26/2022,Princeton,George Mason,6,109,103
349,5217062,Purdue Fort Wayne,3,McKendree,2,5217062,114,111,2/26/2022,Purdue Fort Wayne,McKendree,3,114,111
350,5217161,Alderson Broaddus,1,Fairleigh Dickinson,3,5217161,85,93,2/26/2022,Fairleigh Dickinson,Alderson Broaddus,8,93,85
351,5217205,St. Francis Brooklyn,0,Saint Francis (PA),3,5217205,66,75,2/26/2022,Saint Francis (PA),St. Francis Brooklyn,9,75,66
352,5217250,NJIT,2,Penn St.,3,5217250,102,104,2/26/2022,Penn St.,NJIT,2,104,102
353,5217426,Loyola Chicago,3,Lewis,0,5217426,75,62,2/26/2022,Loyola Chicago,Lewis,13,75,62
354,5217581,BYU,2,Grand Canyon,3,5217581,120,123,2/26/2022,Grand Canyon,BYU,3,123,120
355,5217590,CSUN,3,Stanford,1,5217590,101,86,2/26/2022,CSUN,Stanford,15,101,86
356,5240208,Barton,0,King (TN),3,5240208,56,75,2/26/2022,King (TN),Barton,19,75,56
357,5288485,Southern Va.,0,Tusculum,3,5288485,59,75,2/26/2022,Tusculum,Southern Va.,16,75,59
358,5217866,Nichols,3,American Int'l,0,5217866,77,60,2/27/2022,Nichols,American Int'l,17,77,60
359,5217882,Nichols,3,American Int'l,0,5217882,77,60,2/27/2022,Nichols,American Int'l,17,77,60
360,5217986,LIU,0,Saint Francis (PA),3,5217986,60,75,2/27/2022,Saint Francis (PA),LIU,15,75,60
361,5218320,Nichols,3,American Int'l,1,5218320,99,76,2/27/2022,Nichols,American Int'l,23,99,76
362,5219115,Alderson Broaddus,1,Fairleigh Dickinson,3,5219115,87,98,2/27/2022,Fairleigh Dickinson,Alderson Broaddus,11,98,87
363,5219830,Reinhardt,3,Morehouse,0,5219830,75,20,2/28/2022,Reinhardt,Morehouse,55,75,20
364,5220292,Erskine,0,Limestone,3,5220292,60,77,3/1/2022,Limestone,Erskine,17,77,60
365,5220356,Tusculum,0,Lincoln Memorial,3,5220356,55,75,3/1/2022,Lincoln Memorial,Tusculum,20,75,55
366,5229843,Vanguard,1,CUI,3,5229843,90,102,3/1/2022,CUI,Vanguard,12,102,90
367,5221132,Daemen,3,D'Youville,1,5221132,101,66,3/2/2022,Daemen,D'Youville,35,101,66
368,5221284,King (TN),3,Belmont Abbey,2,5221284,110,102,3/2/2022,King (TN),Belmont Abbey,8,110,102
369,5221316,North Greenville,3,Emmanuel (GA),1,5221316,100,89,3/2/2022,North Greenville,Emmanuel (GA),11,100,89
370,5221336,Lewis,3,Benedictine (IL),0,5221336,75,61,3/2/2022,Lewis,Benedictine (IL),14,75,61
371,5221356,Bluefield Col.,3,Lees-McRae,0,5221356,75,66,3/2/2022,Bluefield Col.,Lees-McRae,9,75,66
372,5221394,Fontbonne,3,Maryville (MO),1,5221394,93,79,3/2/2022,Fontbonne,Maryville (MO),14,93,79
373,5221404,Barton,1,Queens (NC),3,5221404,84,98,3/2/2022,Queens (NC),Barton,14,98,84
374,5221608,UC San Diego,3,Hawaii,2,5221608,108,106,3/2/2022,UC San Diego,Hawaii,2,108,106
375,5222400,Lindenwood,3,Quincy,2,5222400,107,91,3/3/2022,Lindenwood,Quincy,16,107,91
376,5222432,CSUN,0,NJIT,3,5222432,73,81,3/3/2022,NJIT,CSUN,8,81,73
377,5222470,CUI,3,Stanford,2,5222470,104,104,3/3/2022,CUI,Stanford,0,104,104
378,5222739,UCLA,3,Grand Canyon,0,5222739,75,54,3/3/2022,UCLA,Grand Canyon,21,75,54
379,5229265,UC Santa Barbara,3,Cal Lutheran,0,5229265,75,47,3/3/2022,UC Santa Barbara,Cal Lutheran,28,75,47
380,5223145,American Int'l,0,Fairleigh Dickinson,3,5223145,54,75,3/4/2022,Fairleigh Dickinson,American Int'l,21,75,54
381,5223186,Penn St.,3,Charleston (WV),0,5223186,75,45,3/4/2022,Penn St.,Charleston (WV),30,75,45
382,5223187,Fort Valley St.,2,Central St. (OH),3,5223187,103,111,3/4/2022,Central St. (OH),Fort Valley St.,8,111,103
383,5223199,North Greenville,2,Limestone,3,5223199,96,100,3/4/2022,Limestone,North Greenville,4,100,96
384,5223307,Erskine,3,Edward Waters,1,5223307,101,82,3/4/2022,Erskine,Edward Waters,19,101,82
385,5223318,Sacred Heart,1,George Mason,3,5223318,84,99,3/4/2022,George Mason,Sacred Heart,15,99,84
386,5223375,Lewis,3,Emmanuel (GA),0,5223375,75,53,3/4/2022,Lewis,Emmanuel (GA),22,75,53
387,5223392,UCLA,3,Grand Canyon,0,5223392,75,59,3/4/2022,UCLA,Grand Canyon,16,75,59
388,5223464,Barton,1,Tusculum,3,5223464,90,94,3/4/2022,Tusculum,Barton,4,94,90
389,5223496,Loyola Chicago,3,Purdue Fort Wayne,0,5223496,75,61,3/4/2022,Loyola Chicago,Purdue Fort Wayne,14,75,61
390,5223565,Morehouse,0,Kentucky St.,3,5223565,63,76,3/4/2022,Kentucky St.,Morehouse,13,76,63
391,5223568,Harvard,3,Princeton,1,5223568,98,94,3/4/2022,Harvard,Princeton,4,98,94
392,5223618,UC Santa Barbara,3,LIU,0,5223618,75,48,3/4/2022,UC Santa Barbara,LIU,27,75,48
393,5223643,UC San Diego,0,Hawaii,3,5223643,61,75,3/4/2022,Hawaii,UC San Diego,14,75,61
394,5223691,Southern California,3,BYU,1,5223691,93,87,3/4/2022,Southern California,BYU,6,93,87
395,5223714,Long Beach St.,3,NJIT,1,5223714,98,77,3/4/2022,Long Beach St.,NJIT,21,98,77
396,5223715,CUI,3,Stanford,1,5223715,99,92,3/4/2022,CUI,Stanford,7,99,92
397,5227088,McKendree,0,Pepperdine,3,5227088,60,75,3/4/2022,Pepperdine,McKendree,15,75,60
398,5224157,Fort Valley St.,3,Kentucky St.,0,5224157,75,53,3/5/2022,Fort Valley St.,Kentucky St.,22,75,53
399,5224408,Edward Waters,3,Benedict,0,5224408,76,61,3/5/2022,Edward Waters,Benedict,15,76,61
400,5224477,Morehouse,0,Central St. (OH),3,5224477,26,75,3/5/2022,Central St. (OH),Morehouse,49,75,26
401,5224533,Maryville (MO),3,Cornerstone,1,5224533,98,81,3/5/2022,Maryville (MO),Cornerstone,17,98,81
402,5224543,Queens (NC),0,King (TN),3,5224543,54,75,3/5/2022,King (TN),Queens (NC),21,75,54
403,5224650,Quincy,0,Lindenwood,3,5224650,57,75,3/5/2022,Lindenwood,Quincy,18,75,57
404,5224829,Sacred Heart,2,George Mason,3,5224829,108,103,3/5/2022,George Mason,Sacred Heart,-5,103,108
405,5224979,Ohio St.,3,Lincoln Memorial,0,5224979,81,60,3/5/2022,Ohio St.,Lincoln Memorial,21,81,60
406,5225078,McKendree,3,Pepperdine,2,5225078,110,102,3/5/2022,McKendree,Pepperdine,8,110,102
407,5225185,Southern California,3,BYU,0,5225185,75,45,3/5/2022,Southern California,BYU,30,75,45
408,5225320,Long Beach St.,3,LIU,0,5225320,75,47,3/5/2022,Long Beach St.,LIU,28,75,47
409,5225325,Harvard,3,Princeton,1,5225325,97,79,3/5/2022,Harvard,Princeton,18,97,79
410,5225425,Maryville (MO),3,Thomas More,1,5225425,91,81,3/5/2022,Maryville (MO),Thomas More,10,91,81
411,5225429,CUI,2,UC Irvine,3,5225429,99,111,3/5/2022,UC Irvine,CUI,12,111,99
412,5225562,Loyola Chicago,3,Emmanuel (GA),0,5225562,82,71,3/5/2022,Loyola Chicago,Emmanuel (GA),11,82,71
413,5225614,Cumberland (TN),3,Maryville (MO),2,5225614,99,100,3/5/2022,Cumberland (TN),Maryville (MO),-1,99,100
414,5230847,Saint Francis (PA),3,Charleston (WV),1,5230847,98,86,3/5/2022,Saint Francis (PA),Charleston (WV),12,98,86
415,5288434,Mount Olive,3,Tusculum,1,5288434,91,93,3/5/2022,Mount Olive,Tusculum,-2,91,93
416,5226252,Ohio St.,3,Lincoln Memorial,0,5226252,75,56,3/6/2022,Ohio St.,Lincoln Memorial,19,75,56
417,5227680,Fort Valley St.,0,Maryville (MO),3,5227680,69,76,3/7/2022,Maryville (MO),Fort Valley St.,7,76,69
418,5227721,Erskine,3,Alderson Broaddus,0,5227721,75,59,3/7/2022,Erskine,Alderson Broaddus,16,75,59
419,5228552,Morehouse,0,Maryville (MO),3,5228552,35,75,3/8/2022,Maryville (MO),Morehouse,40,75,35
420,5228580,St. Francis Brooklyn,3,Edward Waters,1,5228580,97,84,3/8/2022,St. Francis Brooklyn,Edward Waters,13,97,84
421,5228582,Sacred Heart,3,American Int'l,0,5228582,75,38,3/8/2022,Sacred Heart,American Int'l,37,75,38
422,5228621,Benedict,0,Erskine,3,5228621,50,75,3/8/2022,Erskine,Benedict,25,75,50
423,5228660,Ohio St.,0,Penn St.,3,5228660,65,75,3/8/2022,Penn St.,Ohio St.,10,75,65
424,5228741,Morehouse,0,Maryville (MO),3,5228741,35,75,3/8/2022,Maryville (MO),Morehouse,40,75,35
425,5229418,Lees-McRae,3,Alderson Broaddus,0,5229418,75,56,3/9/2022,Lees-McRae,Alderson Broaddus,19,75,56
426,5229503,Benedict,1,Maryville (MO),3,5229503,82,93,3/9/2022,Maryville (MO),Benedict,11,93,82
427,5229518,Benedict,3,Maryville (MO),1,5229518,104,89,3/9/2022,Benedict,Maryville (MO),15,104,89
428,5229558,LIU,3,Edward Waters,0,5229558,82,68,3/9/2022,LIU,Edward Waters,14,82,68
429,5229780,CUI,1,UC San Diego,3,5229780,98,103,3/9/2022,UC San Diego,CUI,5,103,98
430,5229785,Southern California,3,George Mason,0,5229785,75,52,3/9/2022,Southern California,George Mason,23,75,52
431,5230361,Tusculum,0,King (TN),3,5230361,67,79,3/10/2022,King (TN),Tusculum,12,79,67
432,5230503,UC Santa Barbara,3,CSUN,0,5230503,75,52,3/10/2022,UC Santa Barbara,CSUN,23,75,52
433,5230538,UC Irvine,3,Long Beach St.,2,5230538,107,101,3/10/2022,UC Irvine,Long Beach St.,6,107,101
434,5230553,Hawaii,3,Lewis,0,5230553,75,55,3/10/2022,Hawaii,Lewis,20,75,55
435,5231238,Limestone,0,McKendree,3,5231238,62,75,3/10/2022,McKendree,Limestone,13,75,62
436,5231372,Kentucky St.,0,Edward Waters,3,5231372,47,75,3/11/2022,Edward Waters,Kentucky St.,28,75,47
437,5231465,Saint Francis (PA),3,Fairleigh Dickinson,0,5231465,75,63,3/11/2022,Saint Francis (PA),Fairleigh Dickinson,12,75,63
438,5231509,NJIT,1,Ball St.,3,5231509,110,115,3/11/2022,Ball St.,NJIT,5,115,110
439,5231513,Charleston (WV),0,Purdue Fort Wayne,3,5231513,59,75,3/11/2022,Purdue Fort Wayne,Charleston (WV),16,75,59
440,5231517,Central St. (OH),3,Benedict,0,5231517,75,58,3/11/2022,Central St. (OH),Benedict,17,75,58
441,5231537,Emmanuel (GA),3,Alderson Broaddus,1,5231537,98,78,3/11/2022,Emmanuel (GA),Alderson Broaddus,20,98,78
442,5231589,SUNY New Paltz,3,St. Francis Brooklyn,2,5231589,99,86,3/11/2022,SUNY New Paltz,St. Francis Brooklyn,13,99,86
443,5231649,BYU,3,CUI,0,5231649,75,47,3/11/2022,BYU,CUI,28,75,47
444,5231676,Pepperdine,3,George Mason,0,5231676,75,49,3/11/2022,Pepperdine,George Mason,26,75,49
445,5231714,Lindenwood,3,Lincoln Memorial,2,5231714,106,106,3/11/2022,Lindenwood,Lincoln Memorial,0,106,106
446,5231829,Southern California,3,Vanguard,1,5231829,96,84,3/11/2022,Southern California,Vanguard,12,96,84
447,5231833,Long Beach St.,3,UC Irvine,0,5231833,75,60,3/11/2022,Long Beach St.,UC Irvine,15,75,60
448,5231848,Stanford,3,UCLA,2,5231848,110,100,3/11/2022,Stanford,UCLA,10,110,100
449,5231897,Sacred Heart,2,LIU,3,5231897,104,102,3/11/2022,LIU,Sacred Heart,-2,102,104
450,5232040,CSUN,0,UC Santa Barbara,3,5232040,60,75,3/11/2022,UC Santa Barbara,CSUN,15,75,60
451,5232003,Limestone,3,Quincy,1,5232003,93,74,3/12/2022,Limestone,Quincy,19,93,74
452,5232092,Kentucky St.,0,Benedict,3,5232092,41,75,3/12/2022,Benedict,Kentucky St.,34,75,41
453,5232198,McKendree,0,Lincoln Memorial,3,5232198,64,75,3/12/2022,Lincoln Memorial,McKendree,11,75,64
454,5232380,Central St. (OH),0,Purdue Fort Wayne,3,5232380,59,75,3/12/2022,Purdue Fort Wayne,Central St. (OH),16,75,59
455,5232422,Tusculum,1,Indiana Tech,3,5232422,73,95,3/12/2022,Indiana Tech,Tusculum,22,95,73
456,5232462,Princeton,0,Ball St.,3,5232462,59,76,3/12/2022,Ball St.,Princeton,17,76,59
457,5232492,Charleston (WV),2,King (TN),3,5232492,110,108,3/12/2022,King (TN),Charleston (WV),-2,108,110
458,5232517,Emmanuel (GA),3,Fort Valley St.,1,5232517,96,79,3/12/2022,Emmanuel (GA),Fort Valley St.,17,96,79
459,5232662,Saint Francis (PA),3,Ohio St.,1,5232662,95,93,3/12/2022,Saint Francis (PA),Ohio St.,2,95,93
460,5232684,Grand Canyon,3,Harvard,0,5232684,75,56,3/12/2022,Grand Canyon,Harvard,19,75,56
461,5232805,Stanford,1,UCLA,3,5232805,86,97,3/12/2022,UCLA,Stanford,11,97,86
462,5232809,BYU,3,CUI,1,5232809,94,86,3/12/2022,BYU,CUI,8,94,86
463,5232826,UC Irvine,3,George Mason,1,5232826,98,84,3/12/2022,UC Irvine,George Mason,14,98,84
464,5232849,Hawaii,3,Lewis,1,5232849,103,90,3/12/2022,Hawaii,Lewis,13,103,90
465,5232863,Central St. (OH),3,Edward Waters,1,5232863,97,75,3/12/2022,Central St. (OH),Edward Waters,22,97,75
466,5232973,Lindenwood,3,Limestone,2,5232973,106,98,3/13/2022,Lindenwood,Limestone,8,106,98
467,5233214,Loyola Chicago,3,Daemen,1,5233214,101,89,3/13/2022,Loyola Chicago,Daemen,12,101,89
468,5233405,Penn St.,3,Ohio St.,1,5233405,98,81,3/13/2022,Penn St.,Ohio St.,17,98,81
469,5233426,Lincoln Memorial,2,Quincy,3,5233426,113,111,3/13/2022,Quincy,Lincoln Memorial,-2,111,113
470,5233779,Grand Canyon,3,Harvard,0,5233779,75,60,3/13/2022,Grand Canyon,Harvard,15,75,60
471,5234888,Benedictine (IL),0,Daemen,3,5234888,65,75,3/14/2022,Daemen,Benedictine (IL),10,75,65
472,5236480,Benedict,1,Fort Valley St.,3,5236480,83,99,3/16/2022,Fort Valley St.,Benedict,16,99,83
473,5236564,North Greenville,3,King (TN),0,5236564,75,63,3/16/2022,North Greenville,King (TN),12,75,63
474,5236671,Lees-McRae,3,Belmont Abbey,2,5236671,104,100,3/16/2022,Lees-McRae,Belmont Abbey,4,104,100
475,5236718,Ohio St.,2,Ball St.,3,5236718,112,105,3/16/2022,Ball St.,Ohio St.,-7,105,112
476,5236862,Morehouse,0,Reinhardt,3,5236862,46,75,3/16/2022,Reinhardt,Morehouse,29,75,46
477,5236864,Pepperdine,3,CSUN,0,5236864,75,57,3/16/2022,Pepperdine,CSUN,18,75,57
478,5237432,Purdue Fort Wayne,3,Daemen,2,5237432,105,99,3/17/2022,Purdue Fort Wayne,Daemen,6,105,99
479,5237453,Alderson Broaddus,1,Limestone,3,5237453,77,95,3/17/2022,Limestone,Alderson Broaddus,18,95,77
480,5237503,Lewis,3,McKendree,1,5237503,119,100,3/17/2022,Lewis,McKendree,19,119,100
481,5237530,CUI,3,Ottawa (KS),0,5237530,75,50,3/17/2022,CUI,Ottawa (KS),25,75,50
482,5237896,Alderson Broaddus,0,Limestone,3,5237896,54,75,3/18/2022,Limestone,Alderson Broaddus,21,75,54
483,5238170,Mount Union,1,Daemen,3,5238170,84,101,3/18/2022,Daemen,Mount Union,17,101,84
484,5238209,SUNY Potsdam,0,D'Youville,3,5238209,58,75,3/18/2022,D'Youville,SUNY Potsdam,17,75,58
485,5238239,NJIT,3,Charleston (WV),0,5238239,76,61,3/18/2022,NJIT,Charleston (WV),15,76,61
486,5238243,Queens (NC),0,North Greenville,3,5238243,53,75,3/18/2022,North Greenville,Queens (NC),22,75,53
487,5238316,Fort Valley St.,3,Morehouse,0,5238316,75,38,3/18/2022,Fort Valley St.,Morehouse,37,75,38
488,5238351,Erskine,0,Mount Olive,3,5238351,60,76,3/18/2022,Mount Olive,Erskine,16,76,60
489,5238385,Emmanuel (GA),3,Barton,1,5238385,95,78,3/18/2022,Emmanuel (GA),Barton,17,95,78
490,5238410,Sacred Heart,1,Harvard,3,5238410,77,98,3/18/2022,Harvard,Sacred Heart,21,98,77
491,5238423,Princeton,1,Penn St.,3,5238423,85,98,3/18/2022,Penn St.,Princeton,13,98,85
492,5238547,Grand Canyon,3,Tusculum,0,5238547,75,49,3/18/2022,Grand Canyon,Tusculum,26,75,49
493,5238623,CSUN,0,Pepperdine,3,5238623,42,75,3/18/2022,Pepperdine,CSUN,33,75,42
494,5238634,Southern California,3,Menlo,0,5238634,75,53,3/18/2022,Southern California,Menlo,22,75,53
495,5238662,Long Beach St.,3,CUI,0,5238662,77,62,3/18/2022,Long Beach St.,CUI,15,77,62
496,5240418,George Mason,3,Saint Francis (PA),0,5240418,75,62,3/18/2022,George Mason,Saint Francis (PA),13,75,62
497,5238930,Elmira,3,D'Youville,2,5238930,118,114,3/19/2022,Elmira,D'Youville,4,118,114
498,5238988,Emmanuel (GA),0,Mount Olive,3,5238988,56,75,3/19/2022,Mount Olive,Emmanuel (GA),19,75,56
499,5239102,Belmont Abbey,3,Rutgers-Newark,0,5239102,78,58,3/19/2022,Belmont Abbey,Rutgers-Newark,20,78,58
500,5239216,D'Youville,3,NVU-Johnson,0,5239216,75,60,3/19/2022,D'Youville,NVU-Johnson,15,75,60
501,5239301,Erskine,3,Barton,2,5239301,110,92,3/19/2022,Erskine,Barton,18,110,92
502,5239311,Morehouse,0,Benedict,3,5239311,37,75,3/19/2022,Benedict,Morehouse,38,75,37
503,5239499,King (TN),3,Queens (NC),2,5239499,118,120,3/19/2022,King (TN),Queens (NC),-2,118,120
504,5239750,NJIT,3,Charleston (WV),2,5239750,109,103,3/19/2022,NJIT,Charleston (WV),6,109,103
505,5239759,Princeton,3,Saint Francis (PA),0,5239759,76,62,3/19/2022,Princeton,Saint Francis (PA),14,76,62
506,5239886,Harvard,3,Sacred Heart,1,5239886,98,82,3/19/2022,Harvard,Sacred Heart,16,98,82
507,5239895,Purdue Fort Wayne,1,Loyola Chicago,3,5239895,90,101,3/19/2022,Loyola Chicago,Purdue Fort Wayne,11,101,90
508,5240046,McKendree,3,Lewis,2,5240046,106,96,3/19/2022,McKendree,Lewis,10,106,96
509,5240066,Grand Canyon,3,Tusculum,0,5240066,75,48,3/19/2022,Grand Canyon,Tusculum,27,75,48
510,5240171,Ball St.,3,Ohio St.,1,5240171,99,87,3/19/2022,Ball St.,Ohio St.,12,99,87
511,5240307,Benedictine Mesa,3,Tusculum,1,5240307,95,82,3/19/2022,Benedictine Mesa,Tusculum,13,95,82
512,5291014,Randolph-Macon,2,Belmont Abbey,3,5291014,105,112,3/19/2022,Belmont Abbey,Randolph-Macon,7,112,105
513,5240883,George Mason,0,Penn St.,3,5240883,52,75,3/20/2022,Penn St.,George Mason,23,75,52
514,5240945,Fort Valley St.,1,Edward Waters,3,5240945,78,98,3/20/2022,Edward Waters,Fort Valley St.,20,98,78
515,5242697,Emmanuel (GA),0,Lincoln Memorial,3,5242697,55,76,3/22/2022,Lincoln Memorial,Emmanuel (GA),21,76,55
516,5243039,Benedict,3,Lees-McRae,0,5243039,76,66,3/22/2022,Benedict,Lees-McRae,10,76,66
517,5243049,Belmont Abbey,3,North Greenville,0,5243049,77,62,3/22/2022,Belmont Abbey,North Greenville,15,77,62
518,5243075,Sacred Heart,3,Eastern Nazarene,1,5243075,98,80,3/22/2022,Sacred Heart,Eastern Nazarene,18,98,80
519,5243893,Princeton,3,St. Francis Brooklyn,0,5243893,75,54,3/23/2022,Princeton,St. Francis Brooklyn,21,75,54
520,5244607,Purdue Fort Wayne,0,Lewis,3,5244607,63,75,3/24/2022,Lewis,Purdue Fort Wayne,12,75,63
521,5244635,Morehouse,0,Edward Waters,3,5244635,42,76,3/24/2022,Edward Waters,Morehouse,34,76,42
522,5244647,Loyola Chicago,2,McKendree,3,5244647,107,103,3/24/2022,McKendree,Loyola Chicago,-4,103,107
523,5245261,Kentucky St.,1,Alderson Broaddus,3,5245261,78,95,3/25/2022,Alderson Broaddus,Kentucky St.,17,95,78
524,5245337,LIU,3,American Int'l,0,5245337,75,42,3/25/2022,LIU,American Int'l,33,75,42
525,5245366,Erskine,3,Lees-McRae,0,5245366,75,63,3/25/2022,Erskine,Lees-McRae,12,75,63
526,5245367,Queens (NC),0,Lincoln Memorial,3,5245367,59,77,3/25/2022,Lincoln Memorial,Queens (NC),18,77,59
527,5245376,Penn St.,3,Harvard,0,5245376,75,49,3/25/2022,Penn St.,Harvard,26,75,49
528,5245380,Mount Olive,3,Belmont Abbey,0,5245380,75,61,3/25/2022,Mount Olive,Belmont Abbey,14,75,61
529,5245383,Morehouse,0,UCLA,3,5245383,22,75,3/25/2022,UCLA,Morehouse,53,75,22
530,5245406,Emmanuel (GA),1,King (TN),3,5245406,86,94,3/25/2022,King (TN),Emmanuel (GA),8,94,86
531,5245408,D'Youville,3,Fairleigh Dickinson,1,5245408,94,87,3/25/2022,D'Youville,Fairleigh Dickinson,7,94,87
532,5245477,Saint Francis (PA),2,Sacred Heart,3,5245477,107,110,3/25/2022,Sacred Heart,Saint Francis (PA),3,110,107
533,5245489,Quincy,0,Ball St.,3,5245489,57,77,3/25/2022,Ball St.,Quincy,20,77,57
534,5245492,George Mason,3,NJIT,1,5245492,108,104,3/25/2022,George Mason,NJIT,4,108,104
535,5245541,Barton,0,North Greenville,3,5245541,56,75,3/25/2022,North Greenville,Barton,19,75,56
536,5245597,Lindenwood,3,Ohio St.,2,5245597,112,112,3/25/2022,Lindenwood,Ohio St.,0,112,112
537,5245661,Pepperdine,2,BYU,3,5245661,118,119,3/25/2022,BYU,Pepperdine,1,119,118
538,5245665,CUI,3,Grand Canyon,0,5245665,86,78,3/25/2022,CUI,Grand Canyon,8,86,78
539,5245669,Stanford,3,Southern California,1,5245669,98,86,3/25/2022,Stanford,Southern California,12,98,86
540,5245678,UC San Diego,3,UC Irvine,1,5245678,103,98,3/25/2022,UC San Diego,UC Irvine,5,103,98
541,5245708,Hawaii,3,CSUN,1,5245708,98,84,3/25/2022,Hawaii,CSUN,14,98,84
542,5247440,UC Santa Barbara,0,Long Beach St.,3,5247440,67,76,3/25/2022,Long Beach St.,UC Santa Barbara,9,76,67
543,5245660,Long Beach St.,3,UC Santa Barbara,1,5245660,97,79,3/26/2022,Long Beach St.,UC Santa Barbara,18,97,79
544,5246041,King's (PA),3,American Int'l,0,5246041,75,48,3/26/2022,King's (PA),American Int'l,27,75,48
545,5246078,Kentucky St.,0,Central St. (OH),3,5246078,45,75,3/26/2022,Central St. (OH),Kentucky St.,30,75,45
546,5246168,Barton,0,Belmont Abbey,3,5246168,52,75,3/26/2022,Belmont Abbey,Barton,23,75,52
547,5246172,Erskine,0,King (TN),3,5246172,70,79,3/26/2022,King (TN),Erskine,9,79,70
548,5246205,Emmanuel (GA),3,Lees-McRae,0,5246205,78,68,3/26/2022,Emmanuel (GA),Lees-McRae,10,78,68
549,5246252,Limestone,0,Lincoln Memorial,3,5246252,70,78,3/26/2022,Lincoln Memorial,Limestone,8,78,70
550,5246405,Queens (NC),3,Tusculum,1,5246405,104,91,3/26/2022,Queens (NC),Tusculum,13,104,91
551,5246428,Mount Olive,2,North Greenville,3,5246428,105,113,3/26/2022,North Greenville,Mount Olive,8,113,105
552,5246434,Widener,3,American Int'l,0,5246434,75,53,3/26/2022,Widener,American Int'l,22,75,53
553,5246466,Alderson Broaddus,0,Central St. (OH),3,5246466,41,75,3/26/2022,Central St. (OH),Alderson Broaddus,34,75,41
554,5246602,Daemen,3,Fairleigh Dickinson,0,5246602,75,50,3/26/2022,Daemen,Fairleigh Dickinson,25,75,50
555,5246888,Saint Francis (PA),1,Harvard,3,5246888,107,111,3/26/2022,Harvard,Saint Francis (PA),4,111,107
556,5247012,Fort Valley St.,0,UCLA,3,5247012,29,75,3/26/2022,UCLA,Fort Valley St.,46,75,29
557,5247020,Princeton,3,NJIT,1,5247020,95,87,3/26/2022,Princeton,NJIT,8,95,87
558,5247152,McKendree,3,Purdue Fort Wayne,1,5247152,99,86,3/26/2022,McKendree,Purdue Fort Wayne,13,99,86
559,5247221,Lindenwood,0,Ball St.,3,5247221,59,75,3/26/2022,Ball St.,Lindenwood,16,75,59
560,5247328,Quincy,0,Ohio St.,3,5247328,62,77,3/26/2022,Ohio St.,Quincy,15,77,62
561,5247330,Lewis,0,Loyola Chicago,3,5247330,59,76,3/26/2022,Loyola Chicago,Lewis,17,76,59
562,5247416,Pepperdine,3,BYU,0,5247416,75,62,3/26/2022,Pepperdine,BYU,13,75,62
563,5247432,Stanford,1,Southern California,3,5247432,85,98,3/26/2022,Southern California,Stanford,13,98,85
564,5247457,CUI,1,Grand Canyon,3,5247457,89,93,3/26/2022,Grand Canyon,CUI,4,93,89
565,5247461,UC Irvine,2,UC San Diego,3,5247461,99,110,3/26/2022,UC San Diego,UC Irvine,11,110,99
566,5247477,Hawaii,3,CSUN,0,5247477,76,52,3/26/2022,Hawaii,CSUN,24,76,52
567,5258048,Penn St.,3,Sacred Heart,0,5258048,81,65,3/26/2022,Penn St.,Sacred Heart,16,81,65
568,5265301,George Mason,3,St. Francis Brooklyn,2,5265301,119,122,3/26/2022,George Mason,St. Francis Brooklyn,-3,119,122
569,5247865,Limestone,3,Tusculum,2,5247865,99,96,3/27/2022,Limestone,Tusculum,3,99,96
570,5248217,Edward Waters,0,LIU,3,5248217,69,76,3/27/2022,LIU,Edward Waters,7,76,69
571,5248851,Edward Waters,1,LIU,3,5248851,94,104,3/28/2022,LIU,Edward Waters,10,104,94
572,5249544,Lees-McRae,0,Queens (NC),3,5249544,63,75,3/29/2022,Queens (NC),Lees-McRae,12,75,63
573,5249560,St. Francis Brooklyn,3,Fairleigh Dickinson,0,5249560,75,57,3/29/2022,St. Francis Brooklyn,Fairleigh Dickinson,18,75,57
574,5249611,Mount Olive,3,Barton,0,5249611,75,44,3/29/2022,Mount Olive,Barton,31,75,44
575,5249673,King (TN),1,Lincoln Memorial,3,5249673,86,98,3/29/2022,Lincoln Memorial,King (TN),12,98,86
576,5249679,Alderson Broaddus,3,Geneva,2,5249679,118,106,3/29/2022,Alderson Broaddus,Geneva,12,118,106
577,5249762,Belmont Abbey,2,Emmanuel (GA),3,5249762,104,101,3/29/2022,Emmanuel (GA),Belmont Abbey,-3,101,104
578,5250836,UC Irvine,1,UC Santa Barbara,3,5250836,87,101,3/30/2022,UC Santa Barbara,UC Irvine,14,101,87
579,5251198,Belmont Abbey,0,Limestone,3,5251198,48,75,3/31/2022,Limestone,Belmont Abbey,27,75,48
580,5251200,King (TN),3,Tusculum,0,5251200,86,73,3/31/2022,King (TN),Tusculum,13,86,73
581,5251206,Ball St.,3,McKendree,0,5251206,77,62,3/31/2022,Ball St.,McKendree,15,77,62
582,5251216,Ohio St.,1,Lewis,3,5251216,90,93,3/31/2022,Lewis,Ohio St.,3,93,90
583,5251218,Lindenwood,0,Loyola Chicago,3,5251218,42,75,3/31/2022,Loyola Chicago,Lindenwood,33,75,42
584,5251222,Quincy,0,Purdue Fort Wayne,3,5251222,54,75,3/31/2022,Purdue Fort Wayne,Quincy,21,75,54
585,5251236,Southern California,0,UCLA,3,5251236,59,75,3/31/2022,UCLA,Southern California,16,75,59
586,5251254,Grand Canyon,3,Stanford,0,5251254,75,56,3/31/2022,Grand Canyon,Stanford,19,75,56
587,5251259,UC San Diego,0,CSUN,3,5251259,63,75,3/31/2022,CSUN,UC San Diego,12,75,63
588,5251260,CUI,0,Pepperdine,3,5251260,69,77,3/31/2022,Pepperdine,CUI,8,77,69
589,5251319,Alderson Broaddus,0,Lincoln Memorial,3,5251319,51,75,4/1/2022,Lincoln Memorial,Alderson Broaddus,24,75,51
590,5251396,Lincoln Memorial,3,Carlow,0,5251396,75,28,4/1/2022,Lincoln Memorial,Carlow,47,75,28
591,5251430,Alderson Broaddus,3,Carlow,0,5251430,75,46,4/1/2022,Alderson Broaddus,Carlow,29,75,46
592,5251591,NJIT,3,Sacred Heart,0,5251591,75,47,4/1/2022,NJIT,Sacred Heart,28,75,47
593,5251620,Benedict,3,Kentucky St.,0,5251620,75,51,4/1/2022,Benedict,Kentucky St.,24,75,51
594,5251653,Belmont Abbey,2,Queens (NC),3,5251653,99,113,4/1/2022,Queens (NC),Belmont Abbey,14,113,99
595,5251671,Charleston (WV),1,George Mason,3,5251671,76,97,4/1/2022,George Mason,Charleston (WV),21,97,76
596,5251695,Edward Waters,3,Central St. (OH),1,5251695,100,86,4/1/2022,Edward Waters,Central St. (OH),14,100,86
597,5251701,Fairleigh Dickinson,3,American Int'l,0,5251701,75,58,4/1/2022,Fairleigh Dickinson,American Int'l,17,75,58
598,5251706,St. Francis Brooklyn,0,Harvard,3,5251706,54,75,4/1/2022,Harvard,St. Francis Brooklyn,21,75,54
599,5251712,Mount Olive,3,Emmanuel (GA),0,5251712,75,58,4/1/2022,Mount Olive,Emmanuel (GA),17,75,58
600,5251717,Barton,0,Erskine,3,5251717,61,76,4/1/2022,Erskine,Barton,15,76,61
601,5251745,Morehouse,0,Fort Valley St.,3,5251745,28,75,4/1/2022,Fort Valley St.,Morehouse,47,75,28
602,5251781,Saint Francis (PA),3,Daemen,1,5251781,99,94,4/1/2022,Saint Francis (PA),Daemen,5,99,94
603,5251975,UC Santa Barbara,3,UC Irvine,0,5251975,76,63,4/1/2022,UC Santa Barbara,UC Irvine,13,76,63
604,5252077,Long Beach St.,3,Hawaii,1,5252077,100,97,4/1/2022,Long Beach St.,Hawaii,3,100,97
605,5252232,Edward Waters,3,Kentucky St.,0,5252232,75,47,4/2/2022,Edward Waters,Kentucky St.,28,75,47
606,5252473,Lees-McRae,0,King (TN),3,5252473,63,77,4/2/2022,King (TN),Lees-McRae,14,77,63
607,5252633,Benedict,1,Central St. (OH),3,5252633,74,97,4/2/2022,Central St. (OH),Benedict,23,97,74
608,5252665,Barton,1,Emmanuel (GA),3,5252665,83,97,4/2/2022,Emmanuel (GA),Barton,14,97,83
609,5252689,St. Francis Brooklyn,3,Sacred Heart,2,5252689,101,110,4/2/2022,St. Francis Brooklyn,Sacred Heart,-9,101,110
610,5252794,Mount Olive,3,Erskine,2,5252794,114,108,4/2/2022,Mount Olive,Erskine,6,114,108
611,5252917,Lindenwood,1,Purdue Fort Wayne,3,5252917,80,96,4/2/2022,Purdue Fort Wayne,Lindenwood,16,96,80
612,5252992,NJIT,3,Harvard,0,5252992,75,60,4/2/2022,NJIT,Harvard,15,75,60
613,5253017,North Greenville,3,Belmont Abbey,0,5253017,75,49,4/2/2022,North Greenville,Belmont Abbey,26,75,49
614,5253195,Quincy,0,Loyola Chicago,3,5253195,56,75,4/2/2022,Loyola Chicago,Quincy,19,75,56
615,5253288,Fairleigh Dickinson,1,Princeton,3,5253288,95,103,4/2/2022,Princeton,Fairleigh Dickinson,8,103,95
616,5253416,Ball St.,3,Lewis,0,5253416,76,63,4/2/2022,Ball St.,Lewis,13,76,63
617,5253568,Charleston (WV),2,George Mason,3,5253568,90,105,4/2/2022,George Mason,Charleston (WV),15,105,90
618,5253604,Ohio St.,3,McKendree,2,5253604,109,104,4/2/2022,Ohio St.,McKendree,5,109,104
619,5253641,Saint Francis (PA),0,Penn St.,3,5253641,65,78,4/2/2022,Penn St.,Saint Francis (PA),13,78,65
620,5253910,Grand Canyon,3,Stanford,1,5253910,98,90,4/2/2022,Grand Canyon,Stanford,8,98,90
621,5254001,UCLA,3,Southern California,2,5254001,105,93,4/2/2022,UCLA,Southern California,12,105,93
622,5254005,Pepperdine,3,CUI,0,5254005,75,56,4/2/2022,Pepperdine,CUI,19,75,56
623,5254048,CSUN,0,UC San Diego,3,5254048,71,82,4/2/2022,UC San Diego,CSUN,11,82,71
624,5254088,Long Beach St.,3,Hawaii,1,5254088,96,87,4/2/2022,Long Beach St.,Hawaii,9,96,87
625,5254309,American Int'l,0,LIU,3,5254309,41,75,4/3/2022,LIU,American Int'l,34,75,41
626,5256450,Mount Olive,2,Queens (NC),3,5256450,97,110,4/5/2022,Queens (NC),Mount Olive,13,110,97
627,5256478,Charleston (WV),3,Central St. (OH),0,5256478,75,60,4/5/2022,Charleston (WV),Central St. (OH),15,75,60
628,5256484,North Greenville,3,Lees-McRae,0,5256484,75,53,4/5/2022,North Greenville,Lees-McRae,22,75,53
629,5256500,Belmont Abbey,1,King (TN),3,5256500,93,92,4/5/2022,King (TN),Belmont Abbey,-1,92,93
630,5256516,Emmanuel (GA),3,Erskine,1,5256516,94,83,4/5/2022,Emmanuel (GA),Erskine,11,94,83
631,5256551,LIU,3,St. Francis Brooklyn,2,5256551,111,107,4/5/2022,LIU,St. Francis Brooklyn,4,111,107
632,5257194,Springfield,3,Sacred Heart,0,5257194,75,61,4/6/2022,Springfield,Sacred Heart,14,75,61
633,5257840,McKendree,3,Lindenwood,0,5257840,77,67,4/7/2022,McKendree,Lindenwood,10,77,67
634,5257845,Purdue Fort Wayne,2,Ohio St.,3,5257845,111,113,4/7/2022,Ohio St.,Purdue Fort Wayne,2,113,111
635,5257849,Lewis,3,Quincy,1,5257849,95,77,4/7/2022,Lewis,Quincy,18,95,77
636,5257860,Limestone,2,Emmanuel (GA),3,5257860,106,103,4/7/2022,Emmanuel (GA),Limestone,-3,103,106
637,5257864,Loyola Chicago,3,Ball St.,0,5257864,78,63,4/7/2022,Loyola Chicago,Ball St.,15,78,63
638,5257882,Pepperdine,0,UCLA,3,5257882,69,80,4/7/2022,UCLA,Pepperdine,11,80,69
639,5258246,Kentucky St.,0,Fort Valley St.,3,5258246,51,75,4/8/2022,Fort Valley St.,Kentucky St.,24,75,51
640,5258288,Lees-McRae,1,Mount Olive,3,5258288,83,92,4/8/2022,Mount Olive,Lees-McRae,9,92,83
641,5258308,Fairleigh Dickinson,0,George Mason,3,5258308,56,75,4/8/2022,George Mason,Fairleigh Dickinson,19,75,56
642,5258334,Central St. (OH),3,Morehouse,0,5258334,75,36,4/8/2022,Central St. (OH),Morehouse,39,75,36
643,5258338,King (TN),3,Barton,0,5258338,75,51,4/8/2022,King (TN),Barton,24,75,51
644,5258343,Penn St.,3,St. Francis Brooklyn,0,5258343,75,50,4/8/2022,Penn St.,St. Francis Brooklyn,25,75,50
645,5258397,LIU,1,Sacred Heart,3,5258397,87,96,4/8/2022,Sacred Heart,LIU,9,96,87
646,5258434,Saint Francis (PA),3,NJIT,2,5258434,109,93,4/8/2022,Saint Francis (PA),NJIT,16,109,93
647,5258542,Harvard,1,Charleston (WV),3,5258542,102,107,4/8/2022,Charleston (WV),Harvard,5,107,102
648,5258559,Alderson Broaddus,2,D'Youville,3,5258559,104,108,4/8/2022,D'Youville,Alderson Broaddus,4,108,104
649,5258599,Long Beach St.,3,UC San Diego,0,5258599,81,59,4/8/2022,Long Beach St.,UC San Diego,22,81,59
650,5258600,Southern California,3,CUI,0,5258600,75,61,4/8/2022,Southern California,CUI,14,75,61
651,5258606,Stanford,3,BYU,0,5258606,79,69,4/8/2022,Stanford,BYU,10,79,69
652,5258621,CSUN,1,UC Irvine,3,5258621,92,98,4/8/2022,UC Irvine,CSUN,6,98,92
653,5258651,Hawaii,3,UC Santa Barbara,0,5258651,78,65,4/8/2022,Hawaii,UC Santa Barbara,13,78,65
654,5259460,Tusculum,3,Edward Waters,2,5259460,108,100,4/8/2022,Tusculum,Edward Waters,8,108,100
655,5258669,D'Youville,0,Queens (NC),3,5258669,61,75,4/9/2022,Queens (NC),D'Youville,14,75,61
656,5258671,Lees-McRae,3,Barton,0,5258671,80,67,4/9/2022,Lees-McRae,Barton,13,80,67
657,5258714,King (TN),3,Mount Olive,1,5258714,98,79,4/9/2022,King (TN),Mount Olive,19,98,79
658,5258743,LIU,3,Fairleigh Dickinson,2,5258743,109,103,4/9/2022,LIU,Fairleigh Dickinson,6,109,103
659,5258875,Kentucky St.,3,Morehouse,0,5258875,75,47,4/9/2022,Kentucky St.,Morehouse,28,75,47
660,5258976,Lincoln Memorial,3,Tusculum,0,5258976,75,49,4/9/2022,Lincoln Memorial,Tusculum,26,75,49
661,5259014,Central St. (OH),3,Fort Valley St.,0,5259014,75,58,4/9/2022,Central St. (OH),Fort Valley St.,17,75,58
662,5259085,Emmanuel (GA),1,North Greenville,3,5259085,89,97,4/9/2022,North Greenville,Emmanuel (GA),8,97,89
663,5259127,Erskine,3,Belmont Abbey,2,5259127,103,93,4/9/2022,Erskine,Belmont Abbey,10,103,93
664,5259146,Alderson Broaddus,1,Queens (NC),3,5259146,74,97,4/9/2022,Queens (NC),Alderson Broaddus,23,97,74
665,5259470,Saint Francis (PA),3,St. Francis Brooklyn,0,5259470,84,67,4/9/2022,Saint Francis (PA),St. Francis Brooklyn,17,84,67
666,5259479,Benedict,0,Edward Waters,3,5259479,56,75,4/9/2022,Edward Waters,Benedict,19,75,56
667,5259650,Princeton,3,George Mason,0,5259650,75,56,4/9/2022,Princeton,George Mason,19,75,56
668,5259908,McKendree,3,Quincy,0,5259908,75,59,4/9/2022,McKendree,Quincy,16,75,59
669,5259931,Loyola Chicago,0,Ohio St.,3,5259931,55,75,4/9/2022,Ohio St.,Loyola Chicago,20,75,55
670,5259990,Sacred Heart,3,Lancaster Bible,1,5259990,97,88,4/9/2022,Sacred Heart,Lancaster Bible,9,97,88
671,5260087,Lewis,3,Lindenwood,1,5260087,99,96,4/9/2022,Lewis,Lindenwood,3,99,96
672,5260118,Penn St.,3,NJIT,0,5260118,75,63,4/9/2022,Penn St.,NJIT,12,75,63
673,5260141,Harvard,2,Charleston (WV),3,5260141,107,96,4/9/2022,Charleston (WV),Harvard,-11,96,107
674,5260197,Purdue Fort Wayne,1,Ball St.,3,5260197,105,106,4/9/2022,Ball St.,Purdue Fort Wayne,1,106,105
675,5260263,UCLA,3,Pepperdine,0,5260263,75,61,4/9/2022,UCLA,Pepperdine,14,75,61
676,5260286,UC Irvine,3,CSUN,0,5260286,78,63,4/9/2022,UC Irvine,CSUN,15,78,63
677,5260305,Stanford,3,BYU,2,5260305,118,117,4/9/2022,Stanford,BYU,1,118,117
678,5260332,Hawaii,3,UC Santa Barbara,2,5260332,108,99,4/9/2022,Hawaii,UC Santa Barbara,9,108,99
679,5260334,UC San Diego,3,Long Beach St.,2,5260334,102,101,4/9/2022,UC San Diego,Long Beach St.,1,102,101
680,5262374,CUI,0,Southern California,3,5262374,74,83,4/9/2022,Southern California,CUI,9,83,74
681,5264032,Belmont Abbey,3,Lees-McRae,1,5264032,98,65,4/13/2022,Belmont Abbey,Lees-McRae,33,98,65
682,5265049,Erskine,3,Barton,0,5265049,75,51,4/13/2022,Erskine,Barton,24,75,51
683,5264569,Limestone,1,Queens (NC),3,5264569,85,93,4/14/2022,Queens (NC),Limestone,8,93,85
684,5264676,Pepperdine,3,Stanford,0,5264676,75,56,4/14/2022,Pepperdine,Stanford,19,75,56
685,5265721,NJIT,3,St. Francis Brooklyn,1,5265721,99,90,4/15/2022,NJIT,St. Francis Brooklyn,9,99,90
686,5265730,Princeton,3,Sacred Heart,0,5265730,75,50,4/15/2022,Princeton,Sacred Heart,25,75,50
687,5265735,Central St. (OH),3,Kentucky St.,0,5265735,75,42,4/15/2022,Central St. (OH),Kentucky St.,33,75,42
688,5265775,Edward Waters,3,Fort Valley St.,2,5265775,112,111,4/15/2022,Edward Waters,Fort Valley St.,1,112,111
689,5265866,Charleston (WV),1,Penn St.,3,5265866,76,90,4/15/2022,Penn St.,Charleston (WV),14,90,76
690,5266031,Grand Canyon,2,Southern California,3,5266031,99,101,4/15/2022,Southern California,Grand Canyon,2,101,99
691,5266043,BYU,1,UCLA,3,5266043,82,95,4/15/2022,UCLA,BYU,13,95,82
692,5266059,CUI,0,UC Santa Barbara,3,5266059,66,75,4/15/2022,UC Santa Barbara,CUI,9,75,66
693,5266092,Long Beach St.,3,CSUN,2,5266092,102,105,4/15/2022,Long Beach St.,CSUN,-3,102,105
694,5266360,George Mason,2,Harvard,3,5266360,99,104,4/15/2022,Harvard,George Mason,5,104,99
695,5267730,UC Irvine,0,Hawaii,3,5267730,61,75,4/15/2022,Hawaii,UC Irvine,14,75,61
696,5266323,D'Youville,0,Daemen,3,5266323,59,75,4/16/2022,Daemen,D'Youville,16,75,59
697,5266571,Princeton,3,Sacred Heart,0,5266571,81,61,4/16/2022,Princeton,Sacred Heart,20,81,61
698,5266601,Edward Waters,3,Morehouse,0,5266601,75,39,4/16/2022,Edward Waters,Morehouse,36,75,39
699,5267402,Charleston (WV),3,Saint Francis (PA),1,5267402,93,93,4/16/2022,Charleston (WV),Saint Francis (PA),0,93,93
700,5267471,St. Francis Brooklyn,0,NJIT,3,5267471,51,75,4/16/2022,NJIT,St. Francis Brooklyn,24,75,51
701,5267511,Loyola Chicago,3,Lindenwood,0,5267511,75,61,4/16/2022,Loyola Chicago,Lindenwood,14,75,61
702,5267591,Ball St.,3,Quincy,0,5267591,75,48,4/16/2022,Ball St.,Quincy,27,75,48
703,5267623,Grand Canyon,0,Southern California,3,5267623,69,77,4/16/2022,Southern California,Grand Canyon,8,77,69
704,5267690,McKendree,1,Purdue Fort Wayne,3,5267690,91,99,4/16/2022,Purdue Fort Wayne,McKendree,8,99,91
705,5267693,Lewis,3,Ohio St.,2,5267693,111,106,4/16/2022,Lewis,Ohio St.,5,111,106
706,5267739,Pepperdine,3,Stanford,2,5267739,101,103,4/16/2022,Pepperdine,Stanford,-2,101,103
707,5267742,CSUN,0,Long Beach St.,3,5267742,73,82,4/16/2022,Long Beach St.,CSUN,9,82,73
708,5267747,BYU,2,UCLA,3,5267747,107,111,4/16/2022,UCLA,BYU,4,111,107
709,5268331,UC Irvine,2,Hawaii,3,5268331,101,111,4/16/2022,Hawaii,UC Irvine,10,111,101
710,5268403,UC San Diego,1,UC Santa Barbara,3,5268403,83,93,4/16/2022,UC Santa Barbara,UC San Diego,10,93,83
711,5268411,George Mason,0,Harvard,3,5268411,69,81,4/16/2022,Harvard,George Mason,12,81,69
712,5268631,Fort Valley St.,3,Morehouse,0,5268631,75,33,4/19/2022,Fort Valley St.,Morehouse,42,75,33
713,5268633,Benedict,3,Kentucky St.,0,5268633,75,43,4/19/2022,Benedict,Kentucky St.,32,75,43
714,5268782,Central St. (OH),3,Benedict,1,5268782,99,83,4/19/2022,Central St. (OH),Benedict,16,99,83
715,5268817,Edward Waters,3,Fort Valley St.,2,5268817,104,105,4/19/2022,Edward Waters,Fort Valley St.,-1,104,105
716,5269084,Emmanuel (GA),3,Erskine,2,5269084,111,104,4/19/2022,Emmanuel (GA),Erskine,7,111,104
717,5269087,Mount Olive,3,Belmont Abbey,2,5269087,108,99,4/19/2022,Mount Olive,Belmont Abbey,9,108,99
718,5269439,Fort Valley St.,3,Kentucky St.,0,5269439,75,35,4/20/2022,Fort Valley St.,Kentucky St.,40,75,35
719,5269443,Benedict,3,Morehouse,0,5269443,75,38,4/20/2022,Benedict,Morehouse,37,75,38
720,5269734,Central St. (OH),3,Edward Waters,2,5269734,99,102,4/20/2022,Central St. (OH),Edward Waters,-3,99,102
721,5269790,NJIT,3,George Mason,1,5269790,105,98,4/20/2022,NJIT,George Mason,7,105,98
722,5269809,Fort Valley St.,2,Benedict,3,5269809,107,110,4/20/2022,Benedict,Fort Valley St.,3,110,107
723,5269962,Southern California,3,CUI,0,5269962,75,60,4/20/2022,Southern California,CUI,15,75,60
724,5270016,Ball St.,3,Lewis,0,5270016,75,55,4/20/2022,Ball St.,Lewis,20,75,55
725,5270017,Princeton,3,Saint Francis (PA),0,5270017,75,65,4/20/2022,Princeton,Saint Francis (PA),10,75,65
726,5270201,Loyola Chicago,0,Purdue Fort Wayne,3,5270201,78,84,4/20/2022,Purdue Fort Wayne,Loyola Chicago,6,84,78
727,5270229,Pepperdine,3,BYU,2,5270229,110,106,4/20/2022,Pepperdine,BYU,4,110,106
728,5270255,Grand Canyon,1,Stanford,3,5270255,88,97,4/20/2022,Stanford,Grand Canyon,9,97,88
729,5270324,Edward Waters,3,Benedict,0,5270324,75,57,4/21/2022,Edward Waters,Benedict,18,75,57
730,5270401,Central St. (OH),3,Edward Waters,2,5270401,97,103,4/21/2022,Central St. (OH),Edward Waters,-6,97,103
731,5270526,Harvard,1,NJIT,3,5270526,86,92,4/21/2022,NJIT,Harvard,6,92,86
732,5270677,Penn St.,2,Princeton,3,5270677,104,108,4/21/2022,Princeton,Penn St.,4,108,104
733,5270683,UCLA,2,Stanford,3,5270683,105,101,4/21/2022,Stanford,UCLA,-4,101,105
734,5270715,Southern California,1,Pepperdine,3,5270715,99,100,4/21/2022,Pepperdine,Southern California,1,100,99
735,5270719,UC Santa Barbara,3,CSUN,0,5270719,77,67,4/21/2022,UC Santa Barbara,CSUN,10,77,67
736,5277346,UC San Diego,0,UC Irvine,3,5277346,71,80,4/21/2022,UC Irvine,UC San Diego,9,80,71
737,5270776,Lincoln Memorial,3,Alderson Broaddus,0,5270776,75,50,4/22/2022,Lincoln Memorial,Alderson Broaddus,25,75,50
738,5270777,Fairleigh Dickinson,0,Limestone,3,5270777,47,75,4/22/2022,Limestone,Fairleigh Dickinson,28,75,47
739,5270821,Queens (NC),3,D'Youville,0,5270821,75,46,4/22/2022,Queens (NC),D'Youville,29,75,46
740,5270846,Daemen,3,Tusculum,0,5270846,84,74,4/22/2022,Daemen,Tusculum,10,84,74
741,5271019,Lincoln Memorial,3,Limestone,0,5271019,75,64,4/22/2022,Lincoln Memorial,Limestone,11,75,64
742,5271043,Fairleigh Dickinson,3,Alderson Broaddus,1,5271043,98,75,4/22/2022,Fairleigh Dickinson,Alderson Broaddus,23,98,75
743,5271076,North Greenville,3,Emmanuel (GA),0,5271076,75,51,4/22/2022,North Greenville,Emmanuel (GA),24,75,51
744,5271314,D'Youville,0,Tusculum,3,5271314,55,75,4/22/2022,Tusculum,D'Youville,20,75,55
745,5271602,Hawaii,3,UC Santa Barbara,0,5271602,76,56,4/22/2022,Hawaii,UC Santa Barbara,20,76,56
746,5271620,King (TN),1,Mount Olive,3,5271620,81,93,4/22/2022,Mount Olive,King (TN),12,93,81
747,5277348,Long Beach St.,3,UC Irvine,1,5277348,101,94,4/22/2022,Long Beach St.,UC Irvine,7,101,94
748,5271635,D'Youville,3,Alderson Broaddus,0,5271635,77,62,4/23/2022,D'Youville,Alderson Broaddus,15,77,62
749,5273508,Ball St.,3,Purdue Fort Wayne,0,5273508,78,62,4/23/2022,Ball St.,Purdue Fort Wayne,16,78,62
750,5273513,North Greenville,3,Mount Olive,2,5273513,109,95,4/23/2022,North Greenville,Mount Olive,14,109,95
751,5273571,NJIT,1,Princeton,3,5273571,93,102,4/23/2022,Princeton,NJIT,9,102,93
752,5273688,Pepperdine,3,Stanford,2,5273688,109,101,4/23/2022,Pepperdine,Stanford,8,109,101
753,5273738,Hawaii,3,Long Beach St.,0,5273738,80,74,4/23/2022,Hawaii,Long Beach St.,6,80,74
754,5286782,Fairleigh Dickinson,2,Tusculum,3,5286782,103,110,4/23/2022,Tusculum,Fairleigh Dickinson,7,110,103
755,5281390,Princeton,0,North Greenville,3,5281390,77,90,5/1/2022,North Greenville,Princeton,13,90,77
756,5282356,UCLA,3,Pepperdine,1,5282356,98,91,5/3/2022,UCLA,Pepperdine,7,98,91
757,5288238,Hawaii,3,North Greenville,0,5288238,75,48,5/3/2022,Hawaii,North Greenville,27,75,48
758,5283227,Long Beach St.,3,UCLA,2,5283227,102,89,5/5/2022,Long Beach St.,UCLA,13,102,89
759,5288241,Ball St.,2,Hawaii,3,5288241,107,107,5/5/2022,Hawaii,Ball St.,0,107,107
760,5284706,Hawaii,3,Long Beach St.,0,5284706,75,63,5/7/2022,Hawaii,Long Beach St.,12,75,63
